a a beira	W0	a a beira	a a beira
a a beira de	P	a a beira de	a a beira de
a a ceavoga	W0	a a ceavoga	a a ceavoga
a a fin	W0	a a fin	a a fin
a a fin e a o cabo	W0	a a fin e a o cabo	a a fin e a o cabo
a a forza	W0	a a forza	a a forza
a a longa	W0	a a longa	a a longa
a a marxe	W0	a a marxe	a a marxe
a a medida	W0	a a medida	a a medida
a a parte	W0	a a parte	a a parte
a a présa	W0	a a présa	a a présa
a as avesas	W0	a as avesas	a as avesas
a as carreiras	W0	a as carreiras	a as carreiras
a as cegas	W0	a as cegas	a as cegas
a as escuras	W0	a as escuras	a as escuras
a as présas	W0	a as présas	a as présas
a as rapadas	W0	a as rapadas	a as rapadas
a as veces	W0	a as veces	a as veces
a base de	P	a base de	a base de
a berros	W0	a berros	a berros
a cabalo	W0	a cabalo	a cabalo
a cada canto	W0	a cada canto	a cada canto
a cada pouco	W0	a cada pouco	a cada pouco
a cambio	W0	a cambio	a cambio
a canchaperna	W0	a canchaperna	a cachapernas
a capela	W0	a capela	a capela
a catro patas	W0	a catro patas	a catro patas
a causa de	P	a causa de	a causa de
a cegas	W0	a cegas	a as cegas
a chupe	W0	a chupe	a chupe
a consecuencia de	P	a consecuencia de	a consecuencia de
a conta de	P	a conta de	a a conta de
a continuación	W0	a continuación	a continuación
a contracorrente	W0	a contracorrente	a contracorrente
a contragusto	W0	a contragusto	a contragusto
a contrapelo	W0	a contrapelo	a contrapelo
a correr	W0	a correr	a correr
a costa de	P	a costa de	a a custa de
a dereitas	W0	a dereitas	a dereitas
a diario	W0	a diario	a diario
a diferencia de	P	a diferencia de	a diferenza de
a diferenza de	P	a diferenza de	a diferenza de
a duras penas	W0	a duras penas	a duras penas
a escuso	W0	a escuso	a escuso
a excepción de	P	a excepción de	a excepción de
a feito	W0	a feito	a feito
a fin de	P	a fin de	a fin de
a fin de contas	W0	a fin de contas	a fin de contas
a fondo	W0	a fondo	a fondo
a forza de	P	a forza de	a forza de
a gusto	W0	a gusto	a gusto
a maiores	W0	a maiores	a maiores
a mais	Cc	a mais	e mais
a medida que	Cs	a medida que	a medida que
a menos que	Cs	a menos que	a menos que
a modo	W0	a modo	amodo
a nada que	Cs	a nada que	a nada que
a nado	W0	a nado	a nado
a o azar	W0	a o azar	a o azar
a o bordo de	P	a o bordo de	a o bordo de
a o cabo	W0	a o cabo	a o cabo
a o completo	W0	a o completo	a o completo
a o contrario	W0	a o contrario	a o contrario
a o cuberto	W0	a o cuberto	a cuberto
a o dereito	W0	a o dereito	a o dereito
a o descuberto	W0	a o descuberto	a o descuberto
a o fin	W0	a o fin	a o fin
a o fin e a o cabo	W0	a o fin e a o cabo	a a fin e a o cabo
a o lado	W0	a o lado	a o lado
a o longo de	P	a o longo de	a o longo de
a o lonxe	W0	a o lonxe	a o lonxe
a o mellor	W0	a o mellor	a o mellor
a o menos	W0	a o menos	a o menos
a o momentiño	W0	a o momento	a o momento
a o momento	W0	a o momento	a o momento
a o par	W0	a o par	a o par
a o par de	P	a o par de	a o par de
a o parecer	W0	a o parecer	a o parecer
a o pouco	W0	a o pouco	a o pouco
a o primeiro	W0	a o primeiro	a o primeiro
a o pé	W0	a o pé	a o pé
a o pé de	P	a o pé de	a o pé de
a o quite	W0	a o quite	a o quite
a o raro	W0	a o raro	a o raro
a o redor de	P	a o redor de	a o redor de
a o respecto	W0	a o respecto	a o respecto
a o respecto de	P	a o respecto de	a respecto de
a o revés	W0	a o revés	a o revés
a o tanto	W0	a o tanto	a o tanto
a o xeito	W0	a o xeito	a o xeito
a os poucos	W0	a os poucos	a os poucos
a os pouquiños	W0	a os poucos	a os poucos
a par de	P	a par de	a par de
a penas	Cs	a penas	apenas
a penas	W0	a penas	apenas
a pouco que	Cs	a pouco que	a pouco que
a pre	W0	a pre	a pre
a propósito	W0	a propósito	a propósito
a punto	W0	a punto	a punto
a punto de	P	a punto de	a punto de
a pé	W0	a pé	a pé
a rastro	W0	a rastro	a rastro
a razón de	P	a razón de	a razón de
a raíz de	P	a raíz de	a raíz de
a rebolos	W0	a rebolos	a rebolos
a rente de	P	a rente de	a rentes de
a respecto de	P	a respecto de	a respecto de
a rolos	W0	a rolos	a rolos
a son	W0	a son	a son
a tal hora	W0	a tal hora	a tal hora
a tempo	W0	a tempo	a tempo
a toda costa	W0	a toda costa	a toda costa
a través	W0	a través	a través
a un tempo	W0	a un tempo	a un tempo
acto seguido	W0	acto seguido	acto seguido
agora ben	Cs	agora ben	agora ben
agora que	Cs	agora que	agora que
alto o fogo	Scms	alto o fogo	alto o fogo
arredor de	P	arredor de	arredor de
así a todo	W0	así a todo	así e todo
así como	Cs	así como	así como
así e todo	W0	así e todo	así e todo
así mesmo	W0	así mesmo	así mesmo
así pois	W0	así pois	así pois
así que	Cs	así que	así que
axiña que	Cs	axiña que	axiña que
beira de	P	beira de	beira de
ben como	Cs	ben como	ben como
ben non	W0	ben non	ben non
ben que	Cs	ben que	ben que
boca a boca	Scms	boca a boca	boca a boca
boca a boca	W0	boca a boca	boca a boca
cabalo de batalla	Scms	cabalo de batalla	cabalo de batalla
cabalos de batalla	Scmp	cabalo de batalla	cabalo de batalla
cabo de	P	cabo de	cabo de
camiño de	P	camiño de	camiño de
cando menos	W0	cando menos	cando menos
cando queira que	Cs	cando queira que	cando queira que
canto a	P	canto a	canto a
canto antes	W0	canto antes	canto antes
cara a	P	cara a	cara a
catar se	Cs	catar se	catar se
coches de línea	Scmp	coche de línea	coches de liña
como mínimo	W0	como mínimo	como mínimo
como queira que	Cs	como queira que	como queira que
con respecto a	P	con respecto a	con respecto a
con tal de que	Cs	con tal de que	con tal de que
con tal que	Cs	con tal que	con tal que
con todo	W0	con todo	con todo
conforme a	P	conforme a	conforme a
contra de	P	contra de	contra de
contra reloxo	Scfs	contra reloxo	contrarreloxo
dacordo con	P	dacordo con	de acordo con
dado que	Cs	dado que	dado que
de a cabalo	W0	de a cabalo	de a cabalo
de a feito	W0	de a feito	a feito
de abondo	W0	de abondo	dabondo
de acordo	W0	de acordo	de acordo
de alí a pouco	W0	de alí a pouco	de alí a pouco
de alí a pouquiño	W0	de alí a pouco	de alí a pouco
de aquí a pouco	W0	de aquí a pouco	de aquí a pouco
de aquí a pouquiño	W0	de aquí a pouco	de aquí a pouco
de aí que	Cs	de aí que	de aí que
de broma	W0	de broma	de broma
de bruzos	W0	de bruzos	de bruzos
de camiño	W0	de camiño	de camiño
de cara a	P	de cara a	de cara a
de certo	W0	de certo	de certo
de contadiño	W0	de contado	decontado
de contado	W0	de contado	decontado
de cor	W0	de cor	de cor
de emprestado	W0	de emprestado	de emprestado
de face	W0	de face	de face
de feito	W0	de feito	de feito
de fronte	W0	de fronte	de fronte
de golpe	W0	de golpe	de golpe
de inmediato	W0	de inmediato	de inmediato
de longo	W0	de longo	de longo
de menos	W0	de menos	de menos
de momento	W0	de momento	de momento
de máis	W0	de máis	de máis
de non ser que	Cs	de non ser que	de non ser que
de non ser se	Cs	de non ser se	de non ser se
de novo	W0	de novo	de novo
de o revés	W0	de o revés	de o revés
de paisano	A0aa	de paisano	de paisano
de paisano	A0ap	de paisano	de paisano
de paisano	A0as	de paisano	de paisano
de paisano	A0fa	de paisano	de paisano
de paisano	A0fp	de paisano	de paisano
de paisano	A0fs	de paisano	de paisano
de paisano	A0ma	de paisano	de paisano
de paisano	A0mp	de paisano	de paisano
de paisano	A0ms	de paisano	de paisano
de paisano	W0	de paisano	de paisano
de par de	P	de par de	de par de
de paso	W0	de paso	de paso
de plano	W0	de plano	de plano
de por vida	W0	de por vida	de por vida
de prestado	W0	de prestado	de prestado
de pronto	W0	de pronto	de pronto
de propósito	W0	de propósito	de propósito
de présa	W0	de présa	a a présa
de pé	W0	de pé	de pé
de raro en raro	W0	de raro en raro	de raro en raro
de raíz	W0	de raíz	de raíz
de repente	W0	de repente	de repente
de rodillas	W0	de rodillas	de rodillas
de seguida	W0	de seguida	deseguida
de seguidiña	W0	de seguida	deseguida
de seguido	W0	de seguido	deseguido
de seguro	W0	de seguro	de seguro
de tempo en tempo	W0	de tempo en tempo	de tempo en tempo
de todo	W0	de todo	de todo
de través	W0	de través	de través
de través de	P	de través de	de través de
de unha tirada	W0	de unha tirada	de unha tirada
de vagar	W0	de vagar	devagar
de verdade	W0	de verdade	de verdade
de vez en cando	W0	de vez en cando	de vez en cando
de xeonllos	W0	de xeonllos	de xeonllos
de xoenllos	W0	de xoenllos	de xeonllos
decontado que	Cs	decontado que	decontado que
deica pouco	W0	deica pouco	deica pouco
deica que	Cs	deica que	deica que
deica un pouco	W0	deica un pouco	deica un pouco
dentro de	P	dentro de	dentro de
derredor de	P	derredor de	derredor de
deseguida que	Cs	deseguida que	deseguida que
e iso que	Cs	e iso que	e iso que
e listo	W0	e listo	e listo
e mais	Cc	e mais	e mais
e todo	W0	e todo	e todo
en absoluto	W0	en absoluto	en absoluto
en alto	W0	en alto	en alto
en base a	P	en base a	en base a
en breve	W0	en breve	en breve
en broma	W0	en broma	en broma
en cambio	W0	en cambio	en cambio
en canto	Cs	en canto	en canto
en canto a	P	en canto a	en canto a
en común	W0	en común	en común
en conciencia	W0	en conciencia	en conciencia
en concreto	W0	en concreto	en concreto
en definitiva	W0	en definitiva	en definitiva
en detalle	W0	en detalle	en detalle
en diante	W0	en diante	en diante
en efecto	W0	en efecto	en efecto
en especial	W0	en especial	en especial
en fin	W0	en fin	en fin
en firme	W0	en firme	en firme
en fronte	W0	en fronte	en fronte
en fronte de	P	en fronte de	en fronte de
en frío	W0	en frío	en frío
en liña	W0	en liña	en liña
en orde	W0	en orde	en orde
en orde a	P	en orde a	en orde a
en par de	P	en par de	en par de
en parte	W0	en parte	en parte
en particular	W0	en particular	en particular
en por de	P	en por de	en por de
en precario	W0	en precario	en precario
en punto	W0	en punto	en punto
en pé	W0	en pé	en pé
en público	W0	en público	en público
en rama	W0	en rama	en rama
en relación a	P	en relación a	en relación a
en seguida	W0	en seguida	enseguida
en seguidiña	W0	en seguida	enseguida
en serio	W0	en serio	en serio
en tanto	Cs	en tanto	en tanto
en tempo	W0	en tempo	en tempo
en teoría	W0	en teoría	en teoría
en todo caso	W0	en todo caso	en todo caso
en torno a	P	en torno a	en torno a
en van	W0	en van	en van
en vango	W0	en vango	en vango
en verdade	W0	en verdade	en verdade
encefalopatía esponxiforme	Scfs	encefalopatía esponxiforme	encefalopatía esponxiforme
ende ben	Cs	ende ben	ende ben
ende mal	Cs	ende mal	ende mal
entre tanto	Cs	entre tanto	entre tanto
frente a	P	frente a	fronte a
fronte a	P	fronte a	fronte a
fronte por fronte	W0	fronte por fronte	fronte por fronte
fóra de	P	fóra de	fóra de
gracias a	P	gracias a	grazas a
grazas a	P	grazas a	grazas a
logo que	Cs	logo que	logo que
mal como	Cs	mal como	mal como
mal que	Cs	mal que	mal que
mando a distancia	Scms	mando a distancia	mando a distancia
menos mal	W0	menos mal	menos mal
mentras que	Cs	mentras que	mentres
mentres que	Cs	mentres que	mentres
mentres tanto	Cs	mentres tanto	mentres
mentres tanto	W0	mentres tanto	mentres tanto
mesmo que	Cs	mesmo que	mesmo que
meu Deus	Y	meu Deus	meu Deus
máis ben	W0	máis ben	máis ben
nin que	Cs	nin que	nin que
non ben	W0	non ben	non ben
o outro antonte	W0	o outro antonte	o outro antonte
off line	W0	off line	off line
onda non	Cs	onda non	onda non
onde queira	W0	onde queira	onde queira
ora ben	Cs	ora ben	ora ben
ora que	Cs	ora que	ora que
ou ben	Cc	ou ben	ou ben
ou sexa	Cc	ou sexa	ou sexa
pese a	P	pese a	pese a
pois ben	Cs	pois ben	pois ben
pois que	Cs	pois que	pois que
por ante	P	por ante	por ante
por aí	W0	por aí	por aí
por canto	Cs	por canto	por canto
por cen	W0	por cen	por cento
por certo	W0	por certo	por certo
por completo	W0	por completo	por completo
por conseguinte	Cs	por conseguinte	por conseguinte
por cousa de	P	por cousa de	por cousa de
por culpa de	P	por culpa de	por culpa de
por descontado	W0	por descontado	por suposto
por encima	W0	por encima	por encima
por enriba	W0	por enriba	por enriba
por enteiro	W0	por enteiro	por enteiro
por escrito	W0	por escrito	por escrito
por fin	W0	por fin	por fin
por fortuna	W0	por fortuna	por fortuna
por igual	W0	por igual	por igual
por la contra	W0	por a contra	por a contra
por las boas	W0	por as boas	por as boas
por las malas	W0	por as malas	por as malas
por libre	W0	por libre	por libre
por lo baixo	W0	por o baixo	por o baixo
por lo contrario	W0	por o contrario	por o contrario
por lo menos	W0	por o menos	por o menos
por lo miudiño	W0	por o miúdo	por o miúdo
por lo miudo	W0	por o miudo	por o miúdo
por lo miúdo	W0	por o miúdo	por o miúdo
por lo momento	W0	por o momento	por o momento
por lo pronto	W0	por o pronto	por o de pronto
por lo tanto	Cs	por o tanto	por o tanto
por lo tanto	W0	por o tanto	por o tanto
por lo visto	W0	por o visto	por o visto
por los zarapelos	W0	por os zarapelos	por os zarapelos
por moito que	Cs	por moito que	por moito que
por máis que	Cs	por máis que	por máis que
por pouco que	Cs	por pouco que	por pouco que
por riba	W0	por riba	por riba
por separado	W0	por separado	por separado
por suposto	W0	por suposto	por suposto
por tanto	Cs	por tanto	por o tanto
por tanto	W0	por tanto	por tanto
por veces	W0	por veces	por veces
posto que	Cs	posto que	posto que
pouco a pouco	W0	pouco a pouco	pouco e pouco
pouco e pouco	W0	pouco e pouco	pouco e pouco
pouquiño a pouco	W0	pouco a pouco	pouco e pouco
respecto a	P	respecto a	respecto a
respecto de	P	respecto de	respecto de
se ben	Cs	se ben	se ben
se cadra	W0	se cadra	se cadra
se callar	W0	se callar	se callar
sempre que	Cs	sempre que	sempre que
sen dúbida	W0	sen dúbida	sen dúbida
sen embargo	W0	sen embargo	sen embargo
senón que	Cs	senón que	senón que
si ben	Cs	si ben	se ben
sobre de	P	sobre de	sobre de
só que	Cs	só que	só que
tal vez	W0	tal vez	talvez
tan presto	Cs	tan presto	tan presto
tan pronto	Cs	tan pronto	tan pronto
todo terreo	Scms	todo terreo	todo terreo
todo terreos	Scmp	todo terreo	todo terreo
torre de control	Scfs	torre de control	torre de control
torres de control	Scfp	torre de control	torre de control
tras de	P	tras de	tras de
unha vez	Cs	unha vez	unha vez
unha vez	W0	unha vez	unha vez
unha vez que	Cs	unha vez que	unha vez
verbo de	P	verbo de	verbo de
visto que	Cs	visto que	visto que
xa que	Cs	xa que	xa que
xa que logo	Cs	xa que logo	xa que logo
xunto a	P	xunto a	xunto a
xunto con	P	xunto con	xunto con
xunto de	P	xunto de	xunto de
