sentence_tag	fragmento
expression_tag	expresión
analysis_tag	análisis
analysis_unit_tag	análisis_unidad
unit_tag	unidad
alternatives_tag	alternativas
alternative_tag	alternativa
tag_lemma_tag	etq_lema
form_tag	forma
tag_tag	etiqueta
lemma_tag	lema
constituent_tag	constituyente
valid_attr	válido
valid_values	sí	no
qualifying_tag	información_adicional
qualifying_tags	alargamiento	palabra_cortada	ficticio
qualifying_inline_start_tags	cita_inicio	cita	ruido_inicio	ruido	sigla_inicio	sigla	transcripción_dudosa_inicio	transcripción_dudosa	énfasis_inicio	énfasis	sic_inicio	sic	risa_inicio	risa	lengua_inicio	lengua	comentario_inicio	comentario	observación_inicio	observación	asignación_dudosa_inicio	asignación_dudosa	solapado_inicio	solapado
qualifying_inline_end_tags	cita_fin	cita	ruido_fin	ruido	sigla_fin	sigla	transcripción_dudosa_fin	transcripción_dudosa	énfasis_fin	énfasis	sic_fin	sic	risa_fin	risa	lengua_fin	lengua	comentario_fin	comentario	observación_fin	observación	asignación_dudosa_fin	asignación_dudosa	solapado_fin	solapado
ignoring_inline_start_tags	lengua_inicio	lengua
ignoring_inline_end_tags	lengua_fin	lengua
ignoring_tags	palabra_cortada	ininteligible
empty_tags_included_info	fático	risa	vacilación	ruido	tentativa	ininteligible
