20th Century Fox	Sp00	20th Century Fox
A Barcala	Sp00	A Barcala
A Coruña	Sp00	A Coruña
A Coruña-Ferrol	Sp00	A Coruña-Ferrol
A Coruña-Monforte	Sp00	A Coruña-Monforte
A Coruña-Vigo	Sp00	A Coruña-Vigo
A Fonsagrada	Sp00	A Fonsagrada
A Gracia	Sp00	A Gracia
A Habana	Sp00	A Habana
A Haia	Sp00	A Haia
A Madroa	Sp00	A Madroa
A Meseta	Sp00	A Meseta
A Patagonia	Sp00	A Patagonia
A Peregrina	Sp00	A Peregrina
A Piedade	Sp00	A Piedade
A Piedade	Spfs	A Piedade
A Pobra	Sp00	A Pobra
A Pobra de Brollón	Sp00	A Pobra de Brollón
A Pobra de Trives	Sp00	A Pobra de Trives
A Pobra do Brollón	Sp00	A Pobra do Brollón
A Pobra do Caramiñal	Sp00	A Pobra do Caramiñal
A Pontenova	Sp00	A Pontenova
A Quintana	Sp00	A Quintana
A Rioxa	Sp00	A Rioxa
A Torre	Sp00	A Torre
A Toxa	Sp00	A Toxa
A Veiga	Sp00	A Veiga
A doncela guerreira	Spfs	A doncela guerreira
A frauta máxica	Spfs	A frauta máxica
A guerra de as galaxias	Spfs	A guerra de as galaxias
A-9	Sp00	A-9
A. Baamonde	Sp00	A. Baamonde
A. Cunqueiro	Sp00	A. Cunqueiro
A. Lópes	Sp00	A. Lópes
A. Pérez Prado	Sp00	A. Pérez Prado
ABC	Sp00	ABC
ABC digital	Sp00	ABC digital
ACNUR	Sp00	ACNUR
Abad	Sp00	Abad
Abad Conde	Sp00	Abad Conde
Abadín	Sp00	Abadín
Abalde	Sp00	Abalde
Abanca	Sp00	Abanca
Abby Wambach	Spf0	Abby Wambach
Abdelhakim	Spm0	Abdelhakim
Abdelhakim Ajimi	Spm0	Abdelhakim Ajimi
Abdelkader	Sp00	Abdelkader
Abderrazak Mounib	Spm0	Abderrazak Mounib
Abdón	Spm0	Abdón
Abed Rabbo	Sp00	Abed Rabbo
Abel	Spm0	Abel
Abel Caballero	Spm0	Abel Caballero
Abel Matutes	Spm0	Abel Matutes
Abelardo	Spm0	Abelardo
Abeledo	Sp00	Abeledo
Abelló	Sp00	Abelló
Aberri Eguna	Sp00	Aberri Eguna
Abhisit	Sp00	Abhisit
Abigail Lane	Spf0	Abigail Lane
Abilia	Spf0	Abilia
Aboi	Sp00	Aboi
Aboy	Sp00	Aboy
Abraham	Spm0	Abraham
Abrahán	Spm0	Abrahán
Abraldes	Sp00	Abraldes
Abramovich	Sp00	Abramovich
Abu Dhabi	Sp00	Abu Dhabi
Abu Hamadiyah	Spm0	Abu Hamadiyah
Abu Hamza Muhayer	Spm0	Abu Hamza Muhayer
Abu Jalif	Spm0	Abu Jalif
Abu Mazen	Spm0	Abu Mazen
Abu Mazen-Sharon	Spm0	Abu Mazen-Sharon
Abu Sayya	Spm0	Abu Sayya
Abú Yakub	Spm0	Abú Yakub
Abu Ziad	Spm0	Abu Ziad
Abu Zubaida	Spm0	Abu Zubaida
Abundio	Spm0	Abundio
Academia Galega de Seguridade	Spfs	Academia Galega de Seguridade
Acción Opositora	Sp00	Acción Opositora
Acebes	Sp00	Acebes
Acevin	Sp00	Acevin
Acisclo	Spm0	Acisclo
Acisclo Manzano	Spm0	Acisclo Manzano
Acnur	Sp00	Acnur
Acordos de Oslo	Spmp	Acordos de Oslo
Actimel	Sp00	Actimel
Activision	Sp00	Activision
Acuicultura	Sp00	Acuicultura
Ada	Spf0	Ada
Adalberto	Spm0	Adalberto
Adam	Spm0	Adam
Adam Cohen	Spm0	Adam Cohen
Adam Raga	Spm0	Adam Raga
Adam Smith	Spm0	Adam Smith
Adam Waczynski	Spm0	Adam Waczynski
Adams	Sp00	Adams
Adán	Spm0	Adán
Adela	Spf0	Adela
Adelaida	Spf0	Adelaida
Adelaide	Sp00	Adelaide
Adelaidiña	Spf0	Adelaidiña
Adelson	Spm0	Adelson
Ademar	Spm0	Ademar
Adeslas	Sp00	Adeslas
Adhara Ares	Spf0	Adhara Ares
Adiante	Spfs	Adiante
Adiesg	Sp00	Adiesg
Adil Yukseloglu	Spm0	Adil Yukseloglu
Adiña	Spf0	Adiña
Aditi	Sp00	Aditi
Adjani	Sp00	Adjani
Administración	Spfs	Administración
Administración Penitenciaria	Spfs	Administración Penitenciaria
Adolf Hitler	Spm0	Adolf Hitler
Adolfina	Spf0	Adolfina
Adolfo	Spm0	Adolfo
Adoración	Spf0	Adoración
Adrián	Spm0	Adrián
Adrián Álvarez	Spm0	Adrián Álvarez
Adrián Dios	Spm0	Adrián Dios
Adrián Fernández	Spm0	Adrián Fernández
Adrián Fernández Fdez	Spm0	Adrián Fernández Fdez
Adrián Gómez Diéguez	Spm0	Adrián Gómez Diéguez
Adrián Lence	Spm0	Adrián Lence
Adrián López	Spm0	Adrián López
Adrián Milés	Spm0	Adrián Milés
Adrián Mosquera	Spm0	Adrián Mosquera
Adrián Mosquera Pazos	Spm0	Adrián Mosquera Pazos
Adrián Paz	Spm0	Adrián Paz
Adrián Pérez	Spm0	Adrián Pérez
Adrián Piera	Spm0	Adrián Piera
Adrián Quintairos	Spm0	Adrián Quintairos
Adrián Romero González	Spm0	Adrián Romero González
Adrián Sarasquete	Spm0	Adrián Sarasquete
Adrián Solovio	Spm0	Adrián Solovio
Adrián Vilas	Spm0	Adrián Vilas
Adriana	Spf0	Adriana
Adriático	Spms	Adriático
Adulhalim Demir	Spm0	Adulhalim Demir
Advanced Style	Sp00	Advanced Style
Aebam	Sp00	Aebam
Aed O Loiro	Spm0	Aed O Loiro
Aedenat	Sp00	Aedenat
Aena	Sp00	Aena
Afganistán	Sp00	Afganistán
Afonso	Spm0	Afonso
África	Sp00	África
Agadic	Sp00	Agadic
Agamar	Sp00	Agamar
Agamfec	Sp00	Agamfec
Agamfec	Spfs	Agamfec
Agani	Sp00	Agani
Agapito	Spm0	Agapito
Agasol	Sp00	Agasol
Agatha Christie	Spf0	Agatha Christie
Agestic	Sp00	Agestic
Agnelli	Sp00	Agnelli
Agnus Dei	Spm0	Agnus Dei
Agostiña	Spf0	Agostiña
Agostini	Sp00	Agostini
Agostiño	Spm0	Agostiño
Agricultura	Sp00	Agricultura
Agricultura e Pesca	Sp00	Agricultura e Pesca
Agroinvés	Sp00	Agroinvés
Agrupación Astronómica de Madrid	Spfs	Agrupación Astronómica de Madrid
Águeda	Spf0	Águeda
Aguiar	Sp00	Aguiar
Águila	Sp00	Águila
Aguilar	Sp00	Aguilar
Aguilera	Sp00	Aguilera
Aguiño	Sp00	Aguiño
Aguirretxu	Sp00	Aguirretxu
Agus	Spf0	Agus
Agustín	Spm0	Agustín
Agustina	Spf0	Agustina
Ahern	Sp00	Ahern
Ahmad	Spm0	Ahmad
Ahmadineyad	Sp00	Ahmadineyad
Ahmed	Spm0	Ahmed
Ahmed Abdel Rahman	Spm0	Ahmed Abdel Rahman
Ahmed Jalfan Ghailani	Spm0	Ahmed Jalfan Ghailani
Ahtisaari	Sp00	Ahtisaari
Aimen	Sp00	Aimen
Ainhoa	Spf0	Ainhoa
Ainhoa Arteta	Spf0	Ainhoa Arteta
Ainhoa Fontán	Spf0	Ainhoa Fontán
Ainhoa Ibarra	Spf0	Ainhoa Ibarra
Ainhoa Murúa	Spf0	Ainhoa Murúa
Air Europa	Sp00	Air Europa
Airbus	Sp00	Airbus
Airtel	Sp00	Airtel
Aistech Space	Sp00	Aistech Space
Ajzenberg	Sp00	Ajzenberg
Akhil Reed Amar	Spm0	Akhil Reed Amar
Aki Kaurismaki	Spm0	Aki Kaurismaki
Aki Kaurismäki	Spm0	Aki Kaurismäki
Âkil	Sp00	Âkil
Aladdin Sane	Sp00	Aladdin Sane
Alain Badiou	Spm0	Alain Badiou
Alain Belda	Spm0	Alain Belda
Alain Ducasse	Spm0	Alain Ducasse
Alain Fournier	Spm0	Alain Fournier
Alain Juppé	Spm0	Alain Juppé
Alain Touraine	Spm0	Alain Touraine
Alan D. Sokal	Spm0	Alan D. Sokal
Alan Greenspan	Spm0	Alan Greenspan
Alan Gross	Spm0	Alan Gross
Alan Jackson	Spm0	Alan Jackson
Alan Johnston	Spm0	Alan Johnston
Alan Shearer	Spm0	Alan Shearer
Alan Sokal	Spm0	Alan Sokal
Alan Stern	Spm0	Alan Stern
Alanis Morissette	Spf0	Alanis Morissette
Alanovic	Sp00	Alanovic
Álava	Sp00	Álava
Alawi	Sp00	Alawi
Albacete	Sp00	Albacete
Albania	Sp00	Albania
Albasini	Sp00	Albasini
Alberdi	Sp00	Alberdi
Albert	Spm0	Albert
Albert Alexander	Spm0	Albert Alexander
Albert Boadella	Spm0	Albert Boadella
Albert Camus	Spm0	Albert Camus
Albert Einstein	Spm0	Albert Einstein
Albert Ferrer	Spm0	Albert Ferrer
Albert Gore	Spm0	Albert Gore
Albert Jovell	Spm0	Albert Jovell
Albert Lopo	Spm0	Albert Lopo
Albert Luque	Spm0	Albert Luque
Albert Montañés	Spm0	Albert Montañés
Albert Pla	Spm0	Albert Pla
Albert Plá	Spm0	Albert Plá
Albert Rivera	Spm0	Albert Rivera
Albert Sales	Spm0	Albert Sales
Albert Sánchez Pinyol	Spm0	Albert Sánchez Pinyol
Albert Soler	Spm0	Albert Soler
Albert Uderzo	Spm0	Albert Uderzo
Alberte	Spm0	Alberte
Alberti	Sp00	Alberti
Alberto	Spm0	Alberto
Alberto Bravo	Spm0	Alberto Bravo
Alberto García Alix	Spm0	Alberto García Alix
Alberto Núñez Feijóo	Spm0	Alberto Núñez Feijóo
Alberto Ruiz Gallardón	Spm0	Alberto Ruiz Gallardón
Alberto Sánchez	Spm0	Alberto Sánchez
Alberto Vallarino	Spm0	Alberto Vallarino
Alborch	Sp00	Alborch
Albosat	Sp00	Albosat
Albright	Sp00	Albright
Alcabre	Sp00	Alcabre
Alcaldía	Spfs	Alcaldía
Alcaldía de Bilbao	Spfs	Alcaldía de Bilbao
Alcaldía de Santiago de Compostela	Spfs	Alcaldía de Santiago de Compostela
Alcaldía de Vigo	Spfs	Alcaldía de Vigo
Alcaldía de Vitoria	Spfs	Alcaldía de Vitoria
Alcampo	Sp00	Alcampo
Alcántara	Sp00	Alcántara
Alcàsser	Sp00	Alcàsser
Alcatel	Sp00	Alcatel
Alcatel ELLE	Sp00	Alcatel ELLE
Alcatel Glamphone ELLE	Sp00	Alcatel Glamphone ELLE
Alcatraz	Sp00	Alcatraz
Alcibíades	Spm0	Alcibíades
Alcira	Sp00	Alcira
Alcoa	Sp00	Alcoa
Alcoa Inespal	Sp00	Alcoa Inespal
Alcobaça	Sp00	Alcobaça
Alda Facio	Spf0	Alda Facio
Aldana	Sp00	Aldana
Aldemio	Spm0	Aldemio
Aldo Ceccato	Spm0	Aldo Ceccato
Aldo Leopold	Spm0	Aldo Leopold
Aldo Rossi	Spm0	Aldo Rossi
Aldrey	Sp00	Aldrey
Aleixandre	Sp00	Aleixandre
Aleixo	Spm0	Aleixo
Alejandre	Sp00	Alejandre
Alejandro	Spm0	Alejandro
Alejandro Agag	Spm0	Alejandro Agag
Alejandro Cercas	Spm0	Alejandro Cercas
Alejo	Spm0	Alejo
Alejo Carpentier	Spm0	Alejo Carpentier
Alejo Vidal-Quadras	Spm0	Alejo Vidal-Quadras
Aleksander Kolkowski	Spm0	Aleksander Kolkowski
Aleksander Wolszczan	Spm0	Aleksander Wolszczan
Alemaña	Sp00	Alemaña
Alemani	Sp00	Alemani
Alemania	Sp00	Alemania
Alemao	Sp00	Alemao
Alen	Sp00	Alen
Alessandro Baricco	Spm0	Alessandro Baricco
Alex	Spm0	Alex
Álex	Spm0	Álex
Álex Alonso	Spm0	Álex Alonso
Álex Díez	Spm0	Álex Díez
Álex González	Spm0	Álex González
Álex Grijelmo	Spm0	Álex Grijelmo
Álex López	Spm0	Álex López
Álex Mene	Spm0	Álex Mene
Álex de la Iglesia	Spm0	Álex de la Iglesia
Alexander	Spm0	Alexander
Alexander Bain	Spm0	Alexander Bain
Alexander Gerst	Spm0	Alexander Gerst
Alexander Halcomer	Spm0	Alexander Halcomer
Alexánder Ivánovich	Spm0	Alexánder Ivánovich
Alexander Payne	Spm0	Alexander Payne
Alexander Sadikov	Spm0	Alexander Sadikov
Alexander Von Vegesack	Spm0	Alexander Von Vegesack
Alexandr Kotenkov	Spm0	Alexandr Kotenkov
Alexandra	Spf0	Alexandra
Alexandre	Spm0	Alexandre
Alexandría	Sp00	Alexandría
Alexandro	Spm0	Alexandro
Alexis	Spm0	Alexis
Alexis Kirschbaum	Spm0	Alexis Kirschbaum
Alexis Persanis	Spm0	Alexis Persanis
Alexis W	Spm0	Alexis W
Alexis de Tocqueville	Spm0	Alexis de Tocqueville
Alfageme	Sp00	Alfageme
Alfaro	Sp00	Alfaro
Alfonsín	Sp00	Alfonsín
Alfonso	Spm0	Alfonso
Alfonso Aguila	Spm0	Alfonso Aguila
Alfonso Alonso	Spm0	Alfonso Alonso
Alfonso Cabaleiro	Spm0	Alfonso Cabaleiro
Alfonso Castro	Spm0	Alfonso Castro
Alfonso Perales	Spm0	Alfonso Perales
Alfonso Zulueta	Spm0	Alfonso Zulueta
Alfred	Spm0	Alfred
Alfred Asaro	Spm0	Alfred Asaro
Alfred Hitchcock	Spm0	Alfred Hitchcock
Alfred North Whitehead	Spm0	Alfred North Whitehead
Alfredo	Spm0	Alfredo
Alfredo Pérez Rubalcaba	Spm0	Alfredo Pérez Rubalcaba
Alfredo Suárez Canal	Spm0	Alfredo Suárez Canal
Alfredson	Sp00	Alfredson
Algernon Blackwood	Spm0	Algernon Blackwood
Alguersuari	Sp00	Alguersuari
Alianza	Sp00	Alianza
Alianza	Spfs	Alianza
Alianza Atlántica	Spfs	Alianza Atlántica
Alibós	Sp00	Alibós
Alicante	Sp00	Alicante
Alicia	Spf0	Alicia
Alieto Guadagni	Spm0	Alieto Guadagni
Alipio	Spm0	Alipio
Alito	Spf0	Alito
Alix	Sp00	Alix
Allariz	Sp00	Allariz
Allen	Sp00	Allen
Allen Johnson	Spm0	Allen Johnson
Allen Stewart Konigsberg	Spm0	Allen Stewart Konigsberg
Allen Toussain	Spm0	Allen Toussain
Almanzor	Spm0	Almanzor
Almeida	Sp00	Almeida
Almeida Garrett	Sp00	Almeida Garrett
Almería	Sp00	Almería
Almodóvar	Sp00	Almodóvar
Almudena	Spf0	Almudena
Almudena Ariza	Spf0	Almudena Ariza
Almudena Fernández Fariña	Spf0	Almudena Fernández Fariña
Almudena Grandes	Spf0	Almudena Grandes
Almudena Tabeada Castro	Spf0	Almudena Tabeada Castro
Almunia	Sp00	Almunia
Alok	Sp00	Alok
Alonso	Spm0	Alonso
Alonso Montero	Sp00	Alonso Montero
Alonso Puerta	Spm0	Alonso Puerta
Alphand	Sp00	Alphand
Alsoswa	Sp00	Alsoswa
Alta Comisaría de a ONU para os Refuxiados	Sp00	Alta Comisaría de a ONU para os Refuxiados
Alta Comisaría de as Nacións Unidas para os Refuxiados	Spfs	Alta Comisaría de as Nacións Unidas para os Refuxiados
Altamira	Sp00	Altamira
Altavista	Sp00	Altavista
Altavista Magallanes	Sp00	Altavista Magallanes
Alternativa dos Veciños	Sp00	Alternativa dos Veciños
Althusser	Sp00	Althusser
Altieri	Sp00	Altieri
Altin Gün	Sp00	Altin Gün
Altman	Sp00	Altman
Alto Comisionado de a ONU para os refuxiados	Spms	Alto Comisionado de a ONU para os refuxiados
Alto Comisionado de as Nacións Unidas para os Refuxiados	Spms	Alto Comisionado de as Nacións Unidas para os Refuxiados
Alúmina Aluminio	Sp00	Alúmina Aluminio
Aluminum Company of America	Sp00	Aluminum Company of America
Alvarez	Sp00	Alvarez
Álvarez	Sp00	Álvarez
Alvarez Entrena	Sp00	Alvarez Entrena
Alvarez e Barreras	Sp00	Alvarez e Barreras
Alvarizo Guillón	Sp00	Alvarizo Guillón
Álvaro	Spm0	Álvaro
Alvaro Blanco	Spm0	Alvaro Blanco
Alvedro	Sp00	Alvedro
Alvedro-El Prat	Sp00	Alvedro-El Prat
Alves	Sp00	Alves
Alxeria	Sp00	Alxeria
Alys	Spf0	Alys
Amadeo	Spm0	Amadeo
Amadeo Fernández Sánchez	Spm0	Amadeo Fernández Sánchez
Amadeo Varela	Spm0	Amadeo Varela
Amadeo de Saboya	Spm0	Amadeo de Saboya
Amadeus	Spm0	Amadeus
Amador	Spm0	Amador
Amalia	Spf0	Amalia
Amancio	Spm0	Amancio
Amancio Landín	Spm0	Amancio Landín
Amancio Prada	Spm0	Amancio Prada
Amandi	Sp00	Amandi
Amao	Spm0	Amao
Amara	Spf0	Amara
Amaral	Sp00	Amaral
Amaranta	Spf0	Amaranta
Amarilys	Spf0	Amarilys
Amavisca	Sp00	Amavisca
Amberes	Sp00	Amberes
Ambrosio	Spm0	Ambrosio
Ambrosio Manuel	Spm0	Ambrosio Manuel
Ambrosio de Morales	Spm0	Ambrosio de Morales
Amedo	Sp00	Amedo
Ameijeiras	Sp00	Ameijeiras
Ameixedo	Sp00	Ameixedo
Amelia	Spf0	Amelia
Amelia Romero	Spf0	Amelia Romero
Amelio	Spm0	Amelio
Amenábar	Sp00	Amenábar
América	Sp00	América
América Látina	Sp00	América Látina
America Online	Sp00	America Online
Américo	Spm0	Américo
Ames	Sp00	Ames
Amin Maalouf	Spm0	Amin Maalouf
Aminetu Haidar	Spm0	Aminetu Haidar
Amio	Sp00	Amio
Amnesia	Sp00	Amnesia
Amnistía Internacional	Sp00	Amnistía Internacional
Amoeiro	Sp00	Amoeiro
Amorín	Sp00	Amorín
Amparo	Spf0	Amparo
Amsterdam	Sp00	Amsterdam
Amway Zaragoza	Sp00	Amway Zaragoza
Ana	Spf0	Ana
Ana Botella	Spf0	Ana Botella
Ana Carril	Spf0	Ana Carril
Ana Casas	Spf0	Ana Casas
Ana Castaño	Spf0	Ana Castaño
Ana Sánchez	Spf0	Ana Sánchez
Ana álvarez	Spf0	Ana álvarez
Ana de Palacio	Spf0	Ana de Palacio
Anabam	Sp00	Anabam
Anacleto	Spm0	Anacleto
Anacleto Jiménez	Spm0	Anacleto Jiménez
Anaiansi	Spf0	Anaiansi
Analía López	Spf0	Analía López
Analia Rosa	Spf0	Analia Rosa
Anand	Sp00	Anand
Anari	Spm0	Anari
Anasagasti	Sp00	Anasagasti
Anastas	Sp00	Anastas
Anastasia Steele	Spf0	Anastasia Steele
Anastasio	Spm0	Anastasio
Anatel	Sp00	Anatel
Ancla de Oro	Spfs	Ancla de Oro
Andalucía	Sp00	Andalucía
Ander	Spm0	Ander
Ander Iturriotz	Spm0	Ander Iturriotz
Anderson	Sp00	Anderson
Andoni	Spm0	Andoni
Andoni García	Spm0	Andoni García
Andoni Goikoetxea	Spm0	Andoni Goikoetxea
Andoni Ortuzar	Spm0	Andoni Ortuzar
Andoni Ramos	Spm0	Andoni Ramos
Andorra	Sp00	Andorra
André	Spm0	André
André Agassi	Spm0	André Agassi
André Breton	Spm0	André Breton
Andre Candau	Spm0	Andre Candau
André Candau	Spm0	André Candau
André Cebrián	Spm0	André Cebrián
André Cebrián Garea	Spm0	André Cebrián Garea
Andre Coutant	Spm0	Andre Coutant
André Gluksmann	Spm0	André Gluksmann
André Gorz	Spm0	André Gorz
André López Gómez	Spm0	André López Gómez
André Petitcolin	Spm0	André Petitcolin
André Sabóia	Spm0	André Sabóia
André Santos	Spm0	André Santos
André Sougarret	Spm0	André Sougarret
Andreasen	Sp00	Andreasen
Andreia Agra Ferreiro	Spf0	Andreia Agra Ferreiro
Andreotti	Sp00	Andreotti
Andrés	Spm0	Andrés
Andrés Gaos	Spm0	Andrés Gaos
Andreu	Spm0	Andreu
Andreu Buenafuente	Spm0	Andreu Buenafuente
Andreu García	Spm0	Andreu García
Andreu Nin	Spm0	Andreu Nin
Andrew	Spm0	Andrew
Andrew Card	Spm0	Andrew Card
Andrew Myers	Spm0	Andrew Myers
Andrew Niccol	Spm0	Andrew Niccol
Andrew Parker Bowles	Spm0	Andrew Parker Bowles
Andrew Ramírez	Spm0	Andrew Ramírez
Andrew Strong	Spm0	Andrew Strong
Andrews	Spm0	Andrews
Andrius Pojavis	Spm0	Andrius Pojavis
Andrómeda	Sp00	Andrómeda
Andrzej Zaniewski	Spm0	Andrzej Zaniewski
Andy Christie	Spm0	Andy Christie
Andy Roddick	Spm0	Andy Roddick
Andy Samberg	Spm0	Andy Samberg
Andy Schleck	Spm0	Andy Schleck
Anestesia	Sp00	Anestesia
Anfaco	Sp00	Anfaco
Ángel	Spm0	Ángel
Ángel Acebes	Spm0	Ángel Acebes
Ángel Alkalde Linares	Spm0	Ángel Alkalde Linares
Ángel Baltar	Spm0	Ángel Baltar
Ángel Calderón	Spm0	Ángel Calderón
Ángel Cameselle	Spm0	Ángel Cameselle
Ángel Campos Pámpano	Spm0	Ángel Campos Pámpano
Ángel Campos Varela	Spm0	Ángel Campos Varela
Ángel Carracedo	Spm0	Ángel Carracedo
Ángel Cuéllar	Spm0	Ángel Cuéllar
Ángel Currás	Spm0	Ángel Currás
Ángel Domínguez	Spm0	Ángel Domínguez
Ángel Espadas	Spm0	Ángel Espadas
Ángel Gabilondo	Spm0	Ángel Gabilondo
Ángel García	Spm0	Ángel García
Ángel García Seoane	Spm0	Ángel García Seoane
Ángel Gómez Camarón	Spm0	Ángel Gómez Camarón
Ángel González	Spm0	Ángel González
Ángel González Campuzano	Spm0	Ángel González Campuzano
Ángel González García	Spm0	Ángel González García
Ángel Gurría	Spm0	Ángel Gurría
Ángel Hernasanz	Spm0	Ángel Hernasanz
Ángel Johán	Spm0	Ángel Johán
Ángel Juanes	Spm0	Ángel Juanes
Ángel Lafita	Spm0	Ángel Lafita
Ángel Lockward	Spm0	Ángel Lockward
Ángel López Romalde	Spm0	Ángel López Romalde
Ángel María Villar	Spm0	Ángel María Villar
Ángel Martín	Spm0	Ángel Martín
Ángel Martín Torres	Spm0	Ángel Martín Torres
Ángel Martínez	Spm0	Ángel Martínez
Ángel Nieto	Spm0	Ángel Nieto
Ángel Padín	Spm0	Ángel Padín
Ángel Pérez	Spm0	Ángel Pérez
Ángel Rivas	Spm0	Ángel Rivas
Ángel Rivera	Spm0	Ángel Rivera
Ángel Rojo	Spm0	Ángel Rojo
Ángel Rouco	Spm0	Ángel Rouco
Ángel Ruiz	Spm0	Ángel Ruiz
Ángel Sala	Spm0	Ángel Sala
Ángel Sánchez	Spm0	Ángel Sánchez
Ángel Santamaría	Spm0	Ángel Santamaría
Ángel Schlesser	Spm0	Ángel Schlesser
Ángel Sicart	Spm0	Ángel Sicart
Ángel Stanich	Spm0	Ángel Stanich
Ángel Torres	Spm0	Ángel Torres
Ángel Villalba	Spm0	Ángel Villalba
Ángel Zubieta	Spm0	Ángel Zubieta
Ángel de la Cruz	Spm0	Ángel de la Cruz
Ángel del Castillo	Spm0	Ángel del Castillo
Ángeles Campos	Spf0	Ángeles Campos
Angélica Miñones	Spf0	Angélica Miñones
Angelina	Spf0	Angelina
Angelina García	Spf0	Angelina García
Angelina Jolie	Spf0	Angelina Jolie
Angels Barceló	Spf0	Angels Barceló
Ángels Barceló	Spf0	Ángels Barceló
Àngels Barceló	Spf0	Àngels Barceló
Angers	Sp00	Angers
Anghel	Spm0	Anghel
Angola	Sp00	Angola
Angrois	Sp00	Angrois
Anguita	Sp00	Anguita
Angus Young	Spm0	Angus Young
Ani	Spf0	Ani
Aníbal	Spm0	Aníbal
Aníbal Antonio Cavaco Silva	Spm0	Aníbal Antonio Cavaco Silva
Aníbal C. Malvar	Spm0	Aníbal C. Malvar
Aníbal Lamas	Spm0	Aníbal Lamas
Aníbal Otero	Spm0	Aníbal Otero
Aníbal Otero Fernández	Spm0	Aníbal Otero Fernández
Aniceto Charro Arias	Spm0	Aniceto Charro Arias
Aniceto Pinilla Nunes	Spm0	Aniceto Pinilla Nunes
Anik Nandi	Spm0	Anik Nandi
Anke Huber	Spf0	Anke Huber
Anna	Spf0	Anna
Anna Amorós	Spf0	Anna Amorós
Anna Birulés	Spf0	Anna Birulés
Anna Boyé	Spf0	Anna Boyé
Anna Calvi	Spf0	Anna Calvi
Anna Chapman	Spf0	Anna Chapman
Anna Karenina	Spf0	Anna Karenina
Anna Maria Maiolino	Spf0	Anna Maria Maiolino
Anna Moviek	Spf0	Anna Moviek
Anna Simón	Spf0	Anna Simón
Anna Ternheim	Spf0	Anna Ternheim
Anna Wintour	Spf0	Anna Wintour
Annemarie Jacir	Spf0	Annemarie Jacir
Annette Meakin	Spf0	Annette Meakin
Anni B. Sweet	Spf0	Anni B. Sweet
Annie Allen	Spf0	Annie Allen
Annie Beart	Spf0	Annie Beart
Annie Clark	Spf0	Annie Clark
Annie Lennox	Spf0	Annie Lennox
Ano Internacional dos Maiores	Spms	Ano Internacional dos Maiores
Ano Santo Compostelán	Spms	Ano Santo Compostelán
Anouk	Spf0	Anouk
Anouk Grinberg	Spf0	Anouk Grinberg
Anselmo	Spm0	Anselmo
Ansoney	Sp00	Ansoney
Ansuátegui	Sp00	Ansuátegui
Antealtares	Sp00	Antealtares
Antelo	Sp00	Antelo
Antena 3	Sp00	Antena 3
Antic	Sp00	Antic
Antígona	Spf0	Antígona
Antinori	Sp00	Antinori
Antoine Lahad	Spm0	Antoine Lahad
Antolín	Spm0	Antolín
Antolín Alcántara	Spm0	Antolín Alcántara
Antolín López Peláez	Spm0	Antolín López Peláez
Antolín Sánchez Presedo	Spm0	Antolín Sánchez Presedo
Antolín Sanz	Spm0	Antolín Sanz
Antom	Spm0	Antom
Antom Gómez-Reino	Spm0	Antom Gómez-Reino
Antom Santos	Spm0	Antom Santos
Anton	Spm0	Anton
Antón	Spm0	Antón
Anton Ciobotaru	Spm0	Anton Ciobotaru
Antón Louro	Spm0	Antón Louro
Antón Pombo	Spm0	Antón Pombo
Anton Seoane	Spm0	Anton Seoane
Antona	Spf0	Antona
Antonciño	Spm0	Antónciño
Antonelli	Sp00	Antonelli
Antoñete	Spm0	Antoñete
Antoni Bayona Rocamora	Spm0	Antoni Bayona Rocamora
Antoni Durán Lleida	Spm0	Antoni Durán Lleida
Antoni Giro i Roca	Spm0	Antoni Giro i Roca
Antoni Lloret	Spm0	Antoni Lloret
Antoni Porowski	Spm0	Antoni Porowski
Antoni Ros Marbá	Spm0	Antoni Ros Marbá
Antoni Tàpies	Spm0	Antoni Tàpies
Antonia	Spf0	Antonia
Antonieta	Spf0	Antonieta
Antonin Artaud	Spm0	Antonin Artaud
Antonin Scalia	Spm0	Antonin Scalia
Antonio	Spm0	Antonio
Antonio Aparicio	Spm0	Antonio Aparicio
Antonio Basagoiti	Spm0	Antonio Basagoiti
Antonio Canales	Spm0	Antonio Canales
Antonio Cavaco	Spm0	Antonio Cavaco
Antonio Couceiro	Spm0	Antonio Couceiro
Antonio Erias	Spm0	Antonio Erias
Antonio Gutiérrez	Spm0	Antonio Gutiérrez
Antonio Gutiérrez Díaz	Spm0	Antonio Gutiérrez Díaz
Antonio Juste	Spm0	Antonio Juste
Antonio Lucena	Spm0	Antonio Lucena
Antonio Merino	Spm0	Antonio Merino
Antonio Moreno Barberá	Spm0	Antonio Moreno Barberá
Antonio Romero	Spm0	Antonio Romero
Antonio Vázquez	Spm0	Antonio Vázquez
Antonitsch	Sp00	Antonitsch
Antuña	Sp00	Antuña
Antúnez	Sp00	Antúnez
Anxa	Spf0	Anxa
Ánxel	Spm0	Ánxel
Ánxela Bugallo	Spf0	Ánxela Bugallo
Ánxela Gracián	Spf0	Ánxela Gracián
Ánxela López	Spf0	Ánxela López
Anxo	Spm0	Anxo
Anxo Guerreiro	Spm0	Anxo Guerreiro
Anxo Louzao	Spm0	Anxo Louzao
Anxos	Spf0	Anxos
Aproin	Sp00	Aproin
Aquilino	Spm0	Aquilino
Aquitania	Sp00	Aquitania
Arab News	Sp00	Arab News
Arabia	Sp00	Arabia
Arabia Saudí	Sp00	Arabia Saudí
Arabia Saudita	Sp00	Arabia Saudita
Arabulia	Sp00	Arabulia
Araceli	Spf0	Araceli
Araceli Filgueira	Spf0	Araceli Filgueira
Araceli Freire	Spf0	Araceli Freire
Araceli Ozores	Spf0	Araceli Ozores
Arafat	Sp00	Arafat
Aragón	Sp00	Aragón
Arana	Sp00	Arana
Aranga	Sp00	Aranga
Arango	Sp00	Arango
Araujo	Sp00	Araujo
Arbilla	Sp00	Arbilla
Arcade	Sp00	Arcade
Arcelia Ramírez	Spf0	Arcelia Ramírez
Arctic Monkeys	Sp00	Arctic Monkeys
Ardanza	Sp00	Ardanza
Ardellastres	Sp00	Ardellastres
Área Metropolitana	Spfs	Área Metropolitana
Área de Inmunoloxía	Spfs	Área de Inmunoloxía
Aregio	Sp00	Aregio
Arenal	Sp00	Arenal
Arenas	Sp00	Arenas
Arestín	Sp00	Arestín
Arévalo	Sp00	Arévalo
Argamasilla	Sp00	Argamasilla
Argelio Fernández	Spm0	Argelio Fernández
Argentaria	Sp00	Argentaria
Argerey Vilar	Sp00	Argerey Vilar
Argüelles	Sp00	Argüelles
Argüeyes	Sp00	Argüeyes
Ari Seth	Spm0	Ari Seth
Ari Vatanen	Spm0	Ari Vatanen
Arianna Huffington	Spf0	Arianna Huffington
Arias Cañete	Sp00	Arias Cañete
Arias Navarro	Sp00	Arias Navarro
Arias Salgado	Sp00	Arias Salgado
Arias-Salgado	Sp00	Arias-Salgado
Ariel	Sp00	Ariel
Ariel	Spm0	Ariel
Ariel Pink	Spm0	Ariel Pink
Ariel Sharon	Spm0	Ariel Sharon
Arija	Sp00	Arija
Arion	Sp00	Arion
Aristóteles	Sp00	Aristóteles
Aritz Aduriz	Spm0	Aritz Aduriz
Aritz López Garai	Spm0	Aritz López Garai
Arizona	Sp00	Arizona
Arlecchino	Spm0	Arlecchino
Arlequín	Spm0	Arlequín
Armada	Spfs	Armada
Armand	Spm0	Armand
Armand Basi	Spm0	Armand Basi
Armand Guerra	Spm0	Armand Guerra
Armand Mattelart	Spm0	Armand Mattelart
Armando	Spm0	Armando
Armani	Sp00	Armani
Armaxedón	Sp00	Armaxedón
Armstrong	Sp00	Armstrong
Arnáiz	Sp00	Arnáiz
Arnaldo	Spm0	Arnaldo
Arnaldo Jaber	Spm0	Arnaldo Jaber
Arnaldo Jabor	Spm0	Arnaldo Jabor
Arnaldo Márquez	Spm0	Arnaldo Márquez
Arnaldo Otegi	Spm0	Arnaldo Otegui
Arnaldo Otegui	Spm0	Arnaldo Otegui
Arnaldo de San Martín	Spm0	Arnaldo de San Martín
Arnaud de David	Spm0	Arnaud de David
Arnó	Sp00	Arnó
Arnulfo Arias	Spm0	Arnulfo Arias
Arón	Spm0	Arón
Arousa	Sp00	Arousa
Arpexiña	Spf0	Arpexiña
Arposol	Sp00	Arposol
Arputhavalli	Sp00	Arputhavalli
Arqueoloxía desde o aire	Sp00	Arqueoloxía desde o aire
Arquette	Sp00	Arquette
Arquitecto Marcide	Spms	Arquitecto Marcide
Arquitecto Marcide-Novoa Santos	Sp00	Arquitecto Marcide-Novoa Santos
Arquitectura	Sp00	Arquitectura
Arquivo de Emigración Galega	Spms	Arquivo de Emigración Galega
Arriba Noroeste	Sp00	Arriba Noroeste
Arribas	Sp00	Arribas
Arrieta	Sp00	Arrieta
Arrio	Sp00	Arrio
Arriola	Sp00	Arriola
Arrojo	Sp00	Arrojo
Arsenal de Ferrol	Spms	Arsenal de Ferrol
Arsenio	Spm0	Arsenio
Arsenio Fernández de Mesa	Spm0	Arsenio Fernández de Mesa
Arsuaga	Sp00	Arsuaga
Artaud	Sp00	Artaud
Arteixo	Sp00	Arteixo
Arteixo Telecom	Sp00	Arteixo Telecom
Arteta	Sp00	Arteta
Arturo	Spm0	Arturo
Artús	Spm0	Artús
Arundhati Roy	Spf0	Arundhati Roy
Arxentina	Sp00	Arxentina
Arzallus	Sp00	Arzallus
Arzalluz	Sp00	Arzalluz
Arzúa	Sp00	Arzúa
Arzúa-Melide	Sp00	Arzúa-Melide
As Nogais	Sp00	As Nogais
As Palmas	Sp00	As Palmas
As Pontes	Sp00	As Pontes
As Pontes de García Rodríguez	Sp00	As Pontes de García Rodríguez
As Travesas	Sp00	As Travesas
As catro nais	Spfp	As catro nais
Asad	Sp00	Asad
Asaja	Sp00	Asaja
Ascensión	Spf0	Ascensión
Aschwin Wildeboer	Spm0	Aschwin Wildeboer
Asemblea Lexislativa	Sp00	Asemblea Lexislativa
Asemblea Lexislativa	Spfs	Asemblea Lexislativa
Asemblea Lexislativa de Euskal Herría	Spfs	Asemblea Lexislativa de Euskal Herría
Asemblea de Direccións de Institutos de Ensino Secundario de Galicia	Spfs	Asemblea de Direccións de Institutos de Ensino Secundario de Galicia
Asenjo	Sp00	Asenjo
Aser Estévez	Spm0	Aser Estévez
Asger	Spf0	Asger
Ashley Green	Spf0	Ashley Green
Ashley Madison	Spf0	Ashley Madison
Ashton	Sp00	Ashton
Asia	Sp00	Asia
Asier	Spm0	Asier
Asier Harraiz	Spm0	Asier Harraiz
Asier Mendizabal	Spm0	Asier Mendizabal
Asier Riesgo	Spm0	Asier Riesgo
Asired	Sp00	Asired
Asociación Galega de Editores	Spfs	Asociación Galega de Editores
Asociación Galega de Medicina Familiar e Comunitaria	Spfs	Asociación Galega de Medicina Familiar e Comunitaria
Asociación Galega de Neuroloxía	Spfs	Asociación Galega de Neuroloxía
Asociación Nacional de Fabricantes de Conservas	Spfs	Asociación Nacional de Fabricantes de Conservas
Asociación Nacional de Nacementos Múltiples de México	Spfs	Asociación Nacional de Nacementos Múltiples de México
Asociación de Actores , Directores e Técnicos de Escena de Galicia	Spfs	Asociación de Actores , Directores e Técnicos de Escena de Galicia
Asociación de Afectados por Erros Médicos	Spfs	Asociación de Afectados por Erros Médicos
Asociación de Amigos de Otero Pedrayo	Spfs	Asociación de Amigos de Otero Pedrayo
Asociación de Jóvenes Agricultores	Spfs	Asociación de Jóvenes Agricultores
Asociación de Pais de Alumnos	Spfs	Asociación de Pais de Alumnos
Asociación de Telespectadores e Radioíntes	Spfs	Asociación de Telespectadores e Radioíntes
Asociación de Xemelgos de Alfaro	Spfs	Asociación de Xemelgos de Alfaro
Asorey	Sp00	Asorey
Assumpció Forcada	Spf0	Assumpció Forcada
Assunção	Spfs	Assunção
Astarot	Sp00	Astarot
Asterix	Sp00	Asterix
Astérix	Sp00	Astérix
Astiberri	Sp00	Astiberri
Astiz	Sp00	Astiz
Aston Martin	Sp00	Aston Martin
Astray	Sp00	Astray
Asturias	Sp00	Asturias
Asunción	Spf0	Asunción
Asuntos Exteriores	Sp00	Asuntos Exteriores
Asus	Sp00	Asus
Atelier Van Lieshout	Spm0	Atelier Van Lieshout
Atenágoras	Sp00	Atenágoras
Atención Primaria	Sp00	Atención Primaria
Atención Primaria	Spfs	Atención Primaria
Atilano	Spm0	Atilano
Atlanta	Sp00	Atlanta
Atlas	Spm0	Atlas
Atocha	Sp00	Atocha
Atom Egoyan	Spm0	Atom Egoyan
Audasa	Sp00	Audasa
Audiencia	Spfs	Audiencia
Audiencia Nacional	Sp00	Audiencia Nacional
Audiencia Nacional	Spfs	Audiencia Nacional
Audiencia Provincial	Spfs	Audiencia Provincial
Audiencia de Pontevedra	Spfs	Audiencia de Pontevedra
Auditorio Torrente Ballester	Spms	Auditorio Torrente Ballester
Auditorio de Galicia	Sp00	Auditorio de Galicia
Auditorio de Galicia	Spms	Auditorio de Galicia
Auditorio de a Feira de Mostras de Ferrol	Spms	Auditorio de a Feira de Mostras de Ferrol
Auditorio de a Universidade	Spms	Auditorio de a Universidade
Audrey	Spf0	Audrey
Audrey Tautou	Spf0	Audrey Tautou
Audri Murfhi	Spm0	Audri Murfhi
Augusto	Spm0	Augusto
Augusto César Lendoiro	Spm0	Augusto César Lendoiro
Augusto Pinochet	Spm0	Augusto Pinochet
Augusto Santaló	Spm0	Augusto Santaló
Aula de Cultura de Caixa Galicia	Spfs	Aula de Cultura de Caixa Galicia
Aulet Barros	Sp00	Aulet Barros
Aureli Argemí	Spm0	Aureli Argemí
Aurelia	Spf0	Aurelia
Aurelia García	Spf0	Aurelia García
Aurelia Rey	Spf0	Aurelia Rey
Aureliano	Spm0	Aureliano
Aurelio	Spm0	Aurelio
Aurelio Miras Portugal	Spm0	Aurelio Miras Portugal
Aurelio Pérez Giralda	Spm0	Aurelio Pérez Giralda
Aurora	Spf0	Aurora
Auschwitz	Sp00	Auschwitz
Austin	Sp00	Austin
Austin	Spm0	Austin
Austin Taylor Bice	Spm0	Austin Taylor Bice
Australia	Sp00	Australia
Austria	Sp00	Austria
Austrias	Sp00	Austrias
Autoestrada do Atlántico	Spfs	Autoestrada do Atlántico
Automóbil do Ano en Galicia 99	Sp00	Automóbil do Ano en Galicia 99
Autopistas	Sp00	Autopistas
Autopistas de el Atlántico	Sp00	Autopistas de el Atlántico
Autoridade Portuaria	Spfs	Autoridade Portuaria
Autoservicios Familia	Sp00	Autoservicios Familia
Ávalon	Sp00	Ávalon
Avelina Manuela Fontán Solla	Spf0	Avelina Manuela Fontán Solla
Avelino	Spm0	Avelino
Avencio	Spm0	Avencio
Aviaco	Sp00	Aviaco
Avignon	Sp00	Avignon
Ávila	Sp00	Ávila
Avilés	Sp00	Avilés
Avión	Sp00	Avión
Axel Munthe	Spm0	Axel Munthe
Axencia Municipal de Emprego	Spfs	Axencia Municipal de Emprego
Axencia Tributaria	Spfs	Axencia Tributaria
Axenda 2000	Spfs	Axenda 2000
Ayash	Sp00	Ayash
Aydin Ors	Spm0	Aydin Ors
Aymerich	Sp00	Aymerich
Ayoze	Sp00	Ayoze
Azaña	Sp00	Azaña
Azcárate	Sp00	Azcárate
Azevedo	Sp00	Azevedo
Azkarate	Sp00	Azkarate
Azkárate	Sp00	Azkárate
Aznalcóllar	Sp00	Aznalcóllar
Aznar	Sp00	Aznar
Azorín	Sp00	Azorín
B. Iglesias	Sp00	B. Iglesias
Baamonde	Sp00	Baamonde
Bach	Sp00	Bach
Bachelet	Sp00	Bachelet
Baco	Spm0	Baco
Badajoz	Sp00	Badajoz
Badaxoz	Sp00	Badaxoz
Badiola	Sp00	Badiola
Baena	Sp00	Baena
Bagdad	Sp00	Bagdad
Baggio	Sp00	Baggio
Baglietto	Sp00	Baglietto
Bahrain	Sp00	Bahrain
Bahrein	Sp00	Bahrein
Baikov	Sp00	Baikov
Baiona	Sp00	Baiona
Baires	Sp00	Baires
Bajanavarra	Sp00	Bajanavarra
Bajcetic	Sp00	Bajcetic
Bajnai	Sp00	Bajnai
Bajti	Sp00	Bajti
Bajtin	Sp00	Bajtin
Baker	Sp00	Baker
Bakke	Sp00	Bakke
Bal y Gay	Spfs	Bal y Gay
Balagué	Sp00	Balagué
Balaídos	Sp00	Balaídos
Balcáns	Spmp	Balcáns
Baldomero	Spm0	Baldomero
Baldomir	Sp00	Baldomir
Baldwin	Sp00	Baldwin
Baleares	Sp00	Baleares
Baleares	Spfp	Baleares
Baleira	Sp00	Baleira
Ballester	Sp00	Ballester
Balseiro	Sp00	Balseiro
Baltar	Sp00	Baltar
Baltar Jr.	Sp00	Baltar Jr.
Baltasar	Spm0	Baltasar
Balza	Sp00	Balza
Bancaja	Sp00	Bancaja
Banco Central	Spms	Banco Central
Bandeira Verde de Galicia 1999	Sp00	Bandeira Verde de Galicia 1999
Banegas	Sp00	Banegas
Bangkok	Sp00	Bangkok
Bankinter	Sp00	Bankinter
Bansky	Spm0	Bansky
Baquía	Sp00	Baquía
Bará	Sp00	Bará
Baracaldo	Sp00	Baracaldo
Barack	Sp00	Barack
Barajas	Sp00	Barajas
Barak	Sp00	Barak
Baranga	Sp00	Baranga
Baranzini	Sp00	Baranzini
Baraxas	Sp00	Baraxas
Barbadás	Sp00	Barbadás
Barbanza	Sp00	Barbanza
Bárbara	Spf0	Bárbara
Barberá	Sp00	Barberá
Barbero	Sp00	Barbero
Barbie	Spf0	Barbie
Barcala	Sp00	Barcala
Barceló	Sp00	Barceló
Barcelona	Sp00	Barcelona
Barcelona-A Coruña	Sp00	Barcelona-A Coruña
Barcelos	Sp00	Barcelos
Bárcenas	Sp00	Bárcenas
Barclays	Sp00	Barclays
Bardem	Sp00	Bardem
Bardot	Sp00	Bardot
Barea	Sp00	Barea
Barein	Sp00	Barein
Bargalló	Sp00	Bargalló
Bargnani	Sp00	Bargnani
Bari	Sp00	Bari
Barings	Sp00	Barings
Barja	Sp00	Barja
Barkley	Sp00	Barkley
Barma	Sp00	Barma
Barnier	Sp00	Barnier
Barnum	Sp00	Barnum
Baroja	Sp00	Baroja
Barreiro Rivas	Sp00	Barreiro Rivas
Barreto	Sp00	Barreto
Barrientos	Sp00	Barrientos
Barrionuevo	Sp00	Barrionuevo
Barry Hodge	Spm0	Barry Hodge
Barry Richard	Spm0	Barry Richard
Barrymore	Sp00	Barrymore
Barshefsky	Sp00	Barshefsky
Bart Davenport	Spm0	Bart Davenport
Bartolo Fuentes	Spm0	Bartolo Fuentes
Bartolomé Clavero	Spm0	Bartolomé Clavero
Bartolomé Teijeiro Sanfiz	Spm0	Bartolomé Teijeiro Sanfiz
Bartolomé Vázquez	Spm0	Bartolomé Vázquez
Bartolomé de las Casas	Spm0	Bartolomé de las Casas
Bartolomeu	Spm0	Bartolomeu
Bartz	Sp00	Bartz
Barzani	Sp00	Barzani
Barzin	Sp00	Barzin
Basagoiti	Sp00	Basagoiti
Basayev	Sp00	Basayev
Basilio	Spm0	Basilio
Bassat	Sp00	Bassat
Basso	Sp00	Basso
Batman	Spm0	Batman
Baudelaire	Sp00	Baudelaire
Bautista	Spm0	Bautista
Bayer Munich	Sp00	Bayer Munich
Bayern	Sp00	Bayern
Bayern Múnic	Sp00	Bayern Múnic
Bazán	Sp00	Bazán
Baztarrika	Sp00	Baztarrika
Bea	Spf0	Bea
Beach House	Sp00	Beach House
Beariz	Sp00	Beariz
Beasain	Sp00	Beasain
Beatriz	Spf0	Beatriz
Beaumarchais	Sp00	Beaumarchais
Beaumont	Sp00	Beaumont
Beauregard	Sp00	Beauregard
Beccaría	Sp00	Beccaría
Becerreá	Sp00	Becerreá
Becerril	Sp00	Becerril
Becerril Gómez	Sp00	Becerril Gómez
Beck	Sp00	Beck
Beckett	Sp00	Beckett
Beckhoff	Sp00	Beckhoff
Bécquer	Sp00	Bécquer
Begiristáin	Sp00	Begiristáin
Begoña Caamaño	Spf0	Begoña Caamaño
Begoña Errazti	Spf0	Begoña Errazti
Begoña Lasagabaster	Spf0	Begoña Lasagabaster
Begoña Rubio	Spf0	Begoña Rubio
Begoña Vila	Spf0	Begoña Vila
Beijing	Sp00	Beijing
Beiras	Sp00	Beiras
Beirut	Sp00	Beirut
Bekaert	Sp00	Bekaert
Belarmino	Spm0	Belarmino
Belas Artes	Sp00	Belas Artes
Belenus	Sp00	Belenus
Belesar	Sp00	Belesar
Belfast	Sp00	Belfast
Belgrado	Sp00	Belgrado
Beli Martínez	Spf0	Beli Martínez
Beliador	Spm0	Beliador
Bello	Sp00	Bello
Bello Janeiro	Sp00	Bello Janeiro
Bello Pombo	Sp00	Bello Pombo
Belloch	Sp00	Belloch
Bellot	Sp00	Bellot
Bellow	Sp00	Bellow
Bellucci	Sp00	Bellucci
Belmont	Sp00	Belmont
Belmonte	Sp00	Belmonte
Beloki	Sp00	Beloki
Beltrán	Sp00	Beltrán
Belvis	Sp00	Belvis
Bélxica	Sp00	Bélxica
Benavente	Sp00	Benavente
Benedetti	Sp00	Benedetti
Benedicto	Spm0	Benedicto
Beniamin Netaniahu	Spm0	Beniamin Netaniahu
Benidorm	Sp00	Benidorm
Benigna	Spf0	Benigna
Benigno	Spm0	Benigno
Benítez	Sp00	Benítez
Benítez Reyes	Sp00	Benítez Reyes
Benito	Spm0	Benito
Benjamín Barber	Spm0	Benjamín Barber
Benjamín Barros Novás	Spm0	Benjamín Barros Novás
Benjamín Lubián	Spm0	Benjamín Lubián
Benjamín Martín	Spm0	Benjamín Martín
Benjamin Netanyahu	Spm0	Benjamin Netanyahu
Benjamín Varela Seoane	Spm0	Benjamín Varela Seoane
Benlloch	Sp00	Benlloch
Bennati	Sp00	Bennati
Bennett Greenspan	Spm0	Bennett Greenspan
Bennett Miller	Spm0	Bennett Miller
Bens	Sp00	Bens
Bent	Spm0	Bent
Bent Christensen	Spm0	Bent Christensen
Bentley	Sp00	Bentley
Bentley Mulsanne Speed	Sp00	Bentley Mulsanne Speed
Benxamín	Spm0	Benxamín
Beramendi	Sp00	Beramendi
Berceo	Sp00	Berceo
Bereijo	Sp00	Bereijo
Berezovski	Sp00	Berezovski
Berg	Sp00	Berg
Bergantiños	Sp00	Bergantiños
Berger	Sp00	Berger
Berges	Sp00	Berges
Bergman	Sp00	Bergman
Bergoglio	Sp00	Bergoglio
Berhum	Sp00	Berhum
Beristain	Sp00	Beristain
Berkeley	Sp00	Berkeley
Berkoff	Sp00	Berkoff
Berkshire	Sp00	Berkshire
Berlanga	Sp00	Berlanga
Bérlig	Sp00	Bérlig
Berlín	Sp00	Berlín
Berlin Festival	Sp00	Berlin Festival
Berlusconi	Sp00	Berlusconi
Bermejo	Sp00	Bermejo
Bermejo Martínez, Francisco	Spm0	Bermejo Martínez, Francisco
Bermúdez	Sp00	Bermúdez
Bermúdez de Castro	Sp00	Bermúdez de Castro
Bernabé Costas de Miranda	Spm0	Bernabé Costas de Miranda
Bernal	Sp00	Bernal
Bernaldo	Spm0	Bernaldo
Bernanke	Sp00	Bernanke
Bernard	Spm0	Bernard
Bernard Ecclestone	Spm0	Bernard Ecclestone
Bernard Georges	Spm0	Bernard Georges
Bernard Hopkins	Spm0	Bernard Hopkins
Bernard Schram	Spm0	Bernard Schram
Bernard Schuster	Spm0	Bernard Schuster
Bernard Shaw	Spm0	Bernard Shaw
Bernardino	Spm0	Bernardino
Bernardino González	Spm0	Bernardino González
Bernardino Graña	Spm0	Bernardino Graña
Bernardino Pardo	Spm0	Bernardino Pardo
Bernardo	Spm0	Bernardo
Berners-Lee	Sp00	Berners-Lee
Bernhard	Sp00	Bernhard
Bernstein	Sp00	Bernstein
Berrio	Sp00	Berrio
Berrogüetto	Sp00	Berrogüetto
Berta	Spf0	Berta
Bertels	Sp00	Bertels
Berthier Perregaux	Spm0	Berthier Perregaux
Berto	Spm0	Berto
Bértola	Sp00	Bértola
Bértolo	Sp00	Bértolo
Bertolt Brecht	Spm0	Bertolt Brecht
Bertolucci	Sp00	Bertolucci
Bertomeu	Spm0	Bertomeu
Bertrand Russell	Spm0	Bertrand Russell
Beta	Sp00	Beta
Betagarri	Sp00	Betagarri
Betancourt de Liska	Sp00	Betancourt de Liska
Betanzos	Sp00	Betanzos
Beti	Spf0	Beti
Betti Solleiro	Spf0	Betti Solleiro
Beyoncé	Spf0	Beyoncé
Beyuki	Sp00	Beyuki
Bezsonoff	Sp00	Bezsonoff
Bharwani	Sp00	Bharwani
Bhutto	Sp00	Bhutto
Bianca	Spf0	Bianca
Bianca Cid	Spf0	Bianca Cid
Bianca Cid Bouzas	Spf0	Bianca Cid Bouzas
Bibi Aisha	Spf0	Bibi Aisha
Bieito	Spm0	Bieito
Bieito Lobeira	Spm0	Bieito Lobeira
Bieito Romero	Spm0	Bieito Romero
Bielorrusia	Sp00	Bielorrusia
Big Soul	Sp00	Big Soul
Bilbao	Sp00	Bilbao
Bildarratz	Sp00	Bildarratz
Bill	Spm0	Bill
Bill Bratton	Spm0	Bill Bratton
Bill Clinton	Spm0	Bill Clinton
Bill Collins	Spm0	Bill Collins
Bill Gates	Spm0	Bill Gates
Bill Kirchen	Spm0	Bill Kirchen
Bill Milner	Spm0	Bill Milner
Billie Holiday	Spf0	Billie Holiday
Billig	Sp00	Billig
Billy	Spm0	Billy
Billy Bob Thornton	Spm0	Billy Bob Thornton
Billy Frolic	Spm0	Billy Frolic
Billy Gates	Spm0	Billy Gates
Billy King	Spm0	Billy King
Billy Ray	Spm0	Billy Ray
Billy Squier	Spm0	Billy Squier
Bin Laden	Sp00	Bin Laden
Binyamin Netanyahu	Spm0	Binyamin Netanyahu
Bioloxía Molecular e Celular	Sp00	Bioloxía Molecular e Celular
Birmania	Sp00	Birmania
Birmingham	Sp00	Birmingham
Biscaia	Sp00	Biscaia
Biscet	Sp00	Biscet
Bizet	Sp00	Bizet
Bjelica	Sp00	Bjelica
Bjork	Sp00	Bjork
Björk	Spf0	Björk
Blace	Sp00	Blace
Blagojevich	Sp00	Blagojevich
Blair	Sp00	Blair
Blanc	Sp00	Blanc
Blanco	Sp00	Blanco
Blanco Torres	Sp00	Blanco Torres
Blas	Spm0	Blas
Blatter	Sp00	Blatter
Blay	Sp00	Blay
Blázquez	Sp00	Blázquez
Bliorest	Sp00	Bliorest
Bloom	Sp00	Bloom
Bloque	Spms	Bloque
Bloque Nacionalista Galego	Sp00	Bloque Nacionalista Galego
Bloque Nacionalista Galego	Spms	Bloque Nacionalista Galego
Blunkett	Sp00	Blunkett
Boadella	Sp00	Boadella
Boaventura	Spf0	Boaventura
Bob	Spm0	Bob
Bobadilla	Sp00	Bobadilla
Boccaccio	Sp00	Boccaccio
Boeing	Sp00	Boeing
Bogarde	Sp00	Bogarde
Bogotá	Sp00	Bogotá
Boiro	Sp00	Boiro
Bojic	Sp00	Bojic
Bojkov	Sp00	Bojkov
Boletín de Caixa Galicia	Spms	Boletín de Caixa Galicia
Boloña	Sp00	Boloña
Bolonia	Sp00	Bolonia
Bolsa	Sp00	Bolsa
Bolt	Sp00	Bolt
Bonaval	Sp00	Bonaval
Bonifacio Borreiros	Spm0	Bonifacio Borreiros
Bonilla	Sp00	Bonilla
Bonin	Sp00	Bonin
Bonn	Sp00	Bonn
Bonnie	Sp00	Bonnie
Bono	Sp00	Bono
Bonxe	Sp00	Bonxe
Boqueixón	Sp00	Boqueixón
Borel	Sp00	Borel
Borgen	Sp00	Borgen
Borges	Sp00	Borges
Boris	Spm0	Boris
Boris Eltsin	Spm0	Boris Eltsin
Borís Eltsin	Spm0	Borís Eltsin
Borja	Spm0	Borja
Borja Barbeito	Spm0	Borja Barbeito
Borja Caamaño	Spm0	Borja Caamaño
Borja Cobeaga	Spm0	Borja Cobeaga
Borja Golán	Spm0	Borja Golán
Borja Oubiña	Spm0	Borja Oubiña
Borja Semper	Spm0	Borja Semper
Borja Thyssen	Spm0	Borja Thyssen
Borja Valero	Spm0	Borja Valero
Borobó	Spm0	Borobó
Borodín	Sp00	Borodín
Borrajo	Sp00	Borrajo
Borrás	Sp00	Borrás
Borrel	Sp00	Borrel
Borrell	Sp00	Borrell
Borrow	Sp00	Borrow
Borxa	Sp00	Borxa
Bos Aires	Sp00	Bos Aires
Bosch	Sp00	Bosch
Bosko Jankovic	Spm0	Bosko Jankovic
Bosnia	Sp00	Bosnia
Bosnia Herzogovina	Sp00	Bosnia Herzogovina
Bosnia-Herzegovina	Sp00	Bosnia-Herzegovina
Boston	Sp00	Boston
Boubeta	Sp00	Boubeta
Bouchet	Sp00	Bouchet
Boulez	Sp00	Boulez
Bourges	Sp00	Bourges
Bóveda	Sp00	Bóveda
Boyer	Sp00	Boyer
Bozzo	Sp00	Bozzo
Brad Barnett	Spm0	Brad Barnett
Brad Bushman	Spm0	Brad Bushman
Brad Cox	Spm0	Brad Cox
Brad Davis	Spm0	Brad Davis
Brad Pitt	Spm0	Brad Pitt
Bradford	Sp00	Bradford
Bradley Cooper	Spm0	Bradley Cooper
Bradley Smith	Spm0	Bradley Smith
Brahim Beryaz	Spm0	Brahim Beryaz
Brajkovic	Sp00	Brajkovic
Brancaflor	Spf0	Brancaflor
Brancaneves	Spf0	Brancaneves
Brandariz	Sp00	Brandariz
Brasil	Sp00	Brasil
Bratman	Sp00	Bratman
Braulio	Spm0	Braulio
Braulio Amaro	Spm0	Braulio Amaro
Braulio de el Palacio	Spm0	Braulio de el Palacio
Bravo	Sp00	Bravo
Bread and Roses	Sp00	Bread and Roses
Brendan Curran	Spm0	Brendan Curran
Breogán Autolux	Spm0	Breogán Autolux
Breogán Cachaldora Vidal	Spm0	Breogán Cachaldora Vidal
Breogán Cohen	Spm0	Breogán Cohen
Breogán Ocasión	Sp00	Breogán Ocasión
Brescia	Sp00	Brescia
Brest	Sp00	Brest
Bret Easton Ellis	Sp00	Bret Easton Ellis
Bretaña	Sp00	Bretaña
Breton	Sp00	Breton
Brett Fravre	Spm0	Brett Fravre
Brezhnev	Sp00	Brezhnev
Brian	Spm0	Brian
Brian Berkeley	Spm0	Brian Berkeley
Brian Cusworth	Spm0	Brian Cusworth
Brian Lenihan	Spm0	Brian Lenihan
Brian Marsden	Spm0	Brian Marsden
Brian May	Spm0	Brian May
Brian Nosek	Spm0	Brian Nosek
Brian Tobin	Spm0	Brian Tobin
Brian W. Aldiss	Spm0	Brian W. Aldiss
Brick Lane	Sp00	Brick Lane
Bridget Jones	Spf0	Bridget Jones
Briga	Spf0	Briga
Brigantia	Spf0	Brigantia
Brigantia de San Roque	Spf0	Brigantia de San Roque
Brigantium	Sp00	Brigantium
Brigantium	Spf0	Brigantium
Brigantium	Spm0	Brigantium
Brigitte	Spf0	Brigitte
Briguitte Yague	Spf0	Briguitte Yague
Brión	Sp00	Brión
Bristol	Sp00	Bristol
Britney	Spf0	Britney
Brixton	Sp00	Brixton
Brnovic	Sp00	Brnovic
Brock van der Bogaerde	Spm0	Brock van der Bogaerde
Bror Lindegren	Spm0	Bror Lindegren
Brown	Sp00	Brown
Bruce	Spm0	Bruce
Bruce Ismay	Spm0	Bruce Ismay
Bruce Meyer	Spm0	Bruce Meyer
Bruce Naumann	Spm0	Bruce Naumann
Bruce Springsteen	Spm0	Bruce Springsteen
Bruce Willis	Spm0	Bruce Willis
Bruni	Sp00	Bruni
Bruselas	Sp00	Bruselas
Bruton	Sp00	Bruton
Bruxelas	Sp00	Bruxelas
Bryan Yuzne	Spm0	Bryan Yuzne
Bryant	Sp00	Bryant
Bucaramanga	Sp00	Bucaramanga
Bucarest	Sp00	Bucarest
Buchwitz	Sp00	Buchwitz
Buckingham Palace	Spms	Buckingham Palace
Budapest	Sp00	Budapest
Buenaventura	Sp00	Buenaventura
Buenaventura Durruti	Sp00	Buenaventura Durruti
Buenaventura Núñez Outón	Spm0	Buenaventura Núñez Outón
Bueu	Sp00	Bueu
Bulent Sam	Spm0	Bulent Sam
Bulgaria	Sp00	Bulgaria
Buño	Sp00	Buño
Burela	Sp00	Burela
Burgo de as Nacións	Spfs	Burgo de as Nacións
Burgos	Sp00	Burgos
Burke	Sp00	Burke
Burt Lancaster	Spm0	Burt Lancaster
Burton	Sp00	Burton
Buruaga	Sp00	Buruaga
Burundi	Sp00	Burundi
Busard	Sp00	Busard
Buscapé	Spm0	Buscapé
Busquets	Sp00	Busquets
Busquin	Sp00	Busquin
Bustabad	Sp00	Bustabad
Buster Keaton	Spm0	Buster Keaton
Butaca Especial	Sp00	Butaca Especial
Buteflika	Sp00	Buteflika
Buzard	Sp00	Buzard
Buzzetti	Sp00	Buzzetti
Byron	Sp00	Byron
C. Sanmartín	Sp00	C. Sanmartín
CIG-Ensino	Sp00	CIG-Ensino
CIG-Ensino	Spfs	CIG-Ensino
CV 1D Cumial-Salgueiros	Sp00	CV 1D Cumial-Salgueiros
Cabada	Sp00	Cabada
Cabada Vázquez	Sp00	Cabada Vázquez
Caballé	Sp00	Caballé
Caballero	Sp00	Caballero
Cabanillas	Sp00	Cabanillas
Cabello	Sp00	Cabello
Cabezas	Sp00	Cabezas
Cabo do Mundo	Sp00	Cabo do Mundo
Cabo do mundo	Sp00	Cabo do mundo
Cabrera	Sp00	Cabrera
Cabrera Infante	Sp00	Cabrera Infante
Cacabelos	Sp00	Cacabelos
Cacak	Sp00	Cacak
Cacciari	Sp00	Cacciari
Cáceres	Sp00	Cáceres
Cacharro Pardo	Sp00	Cacharro Pardo
Cáchira	Sp00	Cáchira
Cádiz	Sp00	Cádiz
Caixa Galicia	Sp00	Caixa Galicia
Caixa Ourense	Sp00	Caixa Ourense
Caixa Pontevedra	Sp00	Caixa Pontevedra
Caixa de Aforros de Vigo , Ourense e Pontevedra	Sp00	Caixa de Aforros de Vigo , Ourense e Pontevedra
Caixa de Pontevedra	Sp00	Caixa de Pontevedra
Caixagalicia	Sp00	Caixagalicia
Caixanova	Sp00	Caixanova
Caixanovagalicia	Sp00	Caixanovagalicia
Caixapontevedra	Sp00	Caixapontevedra
Caixavigo	Sp00	Caixavigo
Caixavigo , Ourense e Pontevedra	Sp00	Caixavigo , Ourense e Pontevedra
Caja Madrid	Sp00	Caja Madrid
Caja Postal	Sp00	Caja Postal
Caja San Fernando	Sp00	Caja San Fernando
Caja Segovia	Sp00	Caja Segovia
Caja de Ahorros y Monte de Piedad	Sp00	Caja de Ahorros y Monte de Piedad
Caja de Pontenvedra	Sp00	Caja de Pontenvedra
Cajamar	Sp00	Cajamar
Cajapontevedra	Sp00	Cajapontevedra
Cajide Rodríguez, Roxelio	Spm0	Cajide Rodríguez, Roxelio
Calabria	Sp00	Calabria
Calafat	Sp00	Calafat
Calcuta	Sp00	Calcuta
Caldelas de Tui	Sp00	Caldelas de Tui
Caldevilla	Sp00	Caldevilla
Caldwell	Sp00	Caldwell
Calero	Sp00	Calero
Cali	Sp00	Cali
Calidonia	Sp00	Calidonia
California	Sp00	California
Calígula	Spm0	Calígula
Calros Solla	Spm0	Calros Solla
Calvet	Sp00	Calvet
Calviño	Sp00	Calviño
Camacho	Sp00	Camacho
Cámara	Spfs	Cámara
Cámara Baixa	Spfs	Cámara Baixa
Cámara de Comercio	Spfs	Cámara de Comercio
Cámara de Comercio , Industria e Navegación de Santiago	Spfs	Cámara de Comercio , Industria e Navegación de Santiago
Cámara de Comercio de Pontevedra	Spfs	Cámara de Comercio de Pontevedra
Cámara de Comercio de Santiago	Spfs	Cámara de Comercio de Santiago
Cámara de Comercio de a Coruña	Spfs	Cámara de Comercio de a Coruña
Cámara de Deputados	Spfs	Cámara de Deputados
Cámaras de Comercio	Spfp	Cámaras de Comercio
Camariñas	Sp00	Camariñas
Cambados	Sp00	Cambados
Cambre	Sp00	Cambre
Cambred	Sp00	Cambred
Cambridge	Sp00	Cambridge
Camden Town	Sp00	Camden Town
Camerún	Sp00	Camerún
Camila	Spf0	Camila
Camilla	Spf0	Camilla
Camilla Cavendish	Spf0	Camilla Cavendish
Camilla Parker Bowles	Spf0	Camilla Parker Bowles
Camilleri	Sp00	Camilleri
Camilo	Spm0	Camilo
Camilo Nogueira	Spm0	Camilo Nogueira
Camilo Veiras Candal	Spm0	Camilo Veiras Candal
Camiño Francés	Spms	Camiño Francés
Camino Noia	Spf0	Camino Noia
Camiño de Santiago	Spms	Camiño de Santiago
Camiño de Santiago de Compostela	Spms	Camiño de Santiago de Compostela
Campaña Verán-99	Sp00	Campaña Verán-99
Campbell	Sp00	Campbell
Campbell Field	Sp00	Campbell Field
Campos	Sp00	Campos
Campsa	Sp00	Campsa
Camus	Sp00	Camus
Canadá	Sp00	Canadá
Cánada	Sp00	Cánada
Canadell	Sp00	Canadell
Canal BBV	Sp00	Canal BBV
Canal Satélite	Sp00	Canal Satélite
Canal Satélite Digital	Sp00	Canal Satélite Digital
Canalejo	Sp00	Canalejo
Canarias	Sp00	Canarias
Canarias	Spfp	Canarias
Canavaggio	Sp00	Canavaggio
Candán	Sp00	Candán
Candeloria	Spf0	Candeloria
Candice Bergen	Spf0	Candice Bergen
Cándida	Spf0	Cándida
Cándido	Spm0	Cándido
Cándido Méndez	Spm0	Cándido Méndez
Caneda	Sp00	Caneda
Caneda Aguiar	Sp00	Caneda Aguiar
Canel González, Daniel	Spm0	Canel González, Daniel
Cañete	Sp00	Cañete
Cangas	Sp00	Cangas
Cannes	Sp00	Cannes
Cánovas	Sp00	Cánovas
Cantabria	Sp00	Cantabria
Caparrós	Sp00	Caparrós
Capela Sixtina	Spfs	Capela Sixtina
Capello	Sp00	Capello
Caplan	Sp00	Caplan
Capón	Sp00	Capón
Capriati	Sp00	Capriati
Carabén	Sp00	Carabén
Caracas	Sp00	Caracas
Caramiñas	Sp00	Caramiñas
Caramoniña	Sp00	Caramoniña
Carandell	Sp00	Carandell
Carballedo	Sp00	Carballedo
Carballido	Sp00	Carballido
Carballo	Sp00	Carballo
Carballudo González, Xosé	Spm0	Carballudo González, Xosé
Carbonel	Sp00	Carbonel
Carbonell	Sp00	Carbonell
Cardiff	Sp00	Cardiff
Carey	Sp00	Carey
Caribe	Sp00	Caribe
Caride	Sp00	Caride
Caride Ogando	Sp00	Caride Ogando
Caritel	Sp00	Caritel
Carl	Spm0	Carl
Carla	Spf0	Carla
Carlberg	Sp00	Carlberg
Carlinhos	Spm0	Carlinhos
Carlo	Spm0	Carlo
Carlo Alberto Salustri	Spm0	Carlo Alberto Salustri
Carlo Daffara	Spm0	Carlo Daffara
Carlo Goldoni	Spm0	Carlo Goldoni
Carlo Padial	Spm0	Carlo Padial
Carlo Sorrentino	Spm0	Carlo Sorrentino
Carlos	Spm0	Carlos
Carlos Alberto González Príncipe	Spm0	Carlos Alberto González Príncipe
Carlos Arnáiz	Spm0	Carlos Arnáiz
Carlos Casares	Spm0	Carlos Casares
Carlos Echávarri	Spm0	Carlos Echávarri
Carlos Echavarri Guerra	Spm0	Carlos Echavarri Guerra
Carlos González Príncipe	Spm0	Carlos González Príncipe
Carlos González Reigosa	Spm0	Carlos González Reigosa
Carlos Kase	Spm0	Carlos Kase
Carlos Ladrón de Guevara	Spm0	Carlos Ladrón de Guevara
Carlos Príncipe	Spm0	Carlos Príncipe
Carlos Puertas	Spm0	Carlos Puertas
Carlos Ripoll	Spm0	Carlos Ripoll
Carlota	Spf0	Carlota
Carme	Spf0	Carme
Carme Gallart	Spf0	Carme Gallart
Carmela	Spf0	Carmela
Carmelo	Spm0	Carmelo
Carmelo Barrio	Spm0	Carmelo Barrio
Carmelo Gómez	Spm0	Carmelo Gómez
Carmelo Luis Soria Espinoza	Spm0	Carmelo Luis Soria Espinoza
Carmelo Matalobos	Spm0	Carmelo Matalobos
Carmen	Spf0	Carmen
Carmen Buitrón Gerner	Spf0	Carmen Buitrón Gerner
Carmen Fraga	Spf0	Carmen Fraga
Carmen Linares	Spf0	Carmen Linares
Carmen Mur	Spf0	Carmen Mur
Carmiña	Spf0	Carmiña
Carol	Spf0	Carol
Carol Bouquet	Spf0	Carol Bouquet
Carol Sloane	Spf0	Carol Sloane
Carol Stoker	Spf0	Carol Stoker
Carol de Swan	Spf0	Carol de Swan
Carolina	Spf0	Carolina
Carpentier	Sp00	Carpentier
Carracao	Sp00	Carracao
Carracedo	Sp00	Carracedo
Carral	Sp00	Carral
Carré Aldao	Sp00	Carré Aldao
Carrefour	Sp00	Carrefour
Carreño	Sp00	Carreño
Carreño Tato	Sp00	Carreño Tato
Carrera	Sp00	Carrera
Carrera Pásaro	Sp00	Carrera Pásaro
Carril	Sp00	Carril
Carrillo	Sp00	Carrillo
Carrillo Fuentes	Sp00	Carrillo Fuentes
Carrington	Sp00	Carrington
Carroll	Sp00	Carroll
Carson	Sp00	Carson
Carta Magna	Spfs	Carta Magna
Cartaxena	Sp00	Cartaxena
Cartelle	Sp00	Cartelle
Carter	Sp00	Carter
Cartlin Moran	Spf0	Cartlin Moran
Casa Branca	Spfs	Casa Branca
Casa Hamlet	Sp00	Casa Hamlet
Casa de Láncara	Spfs	Casa de Láncara
Casa do Príncipe	Spfs	Casa do Príncipe
Casanova	Sp00	Casanova
Casas	Sp00	Casas
Caselas	Sp00	Caselas
Casey Blanton	Spm0	Casey Blanton
Casey Stoner	Spm0	Casey Stoner
Cash y Carry	Sp00	Cash y Carry
Casillas	Sp00	Casillas
Casim	Spm0	Casim
Casiopea	Sp00	Casiopea
Cassez	Sp00	Cassez
Cassier	Sp00	Cassier
Castela	Sp00	Castela
Castela e León	Sp00	Castela e León
Castela-A Mancha	Sp00	Castela-A Mancha
Castela-León	Sp00	Castela-León
Castelao	Sp00	Castelao
Castelló	Sp00	Castelló
Castellón	Sp00	Castellón
Castilla	Sp00	Castilla
Castor Gago	Spm0	Castor Gago
Castrelo de Miño	Sp00	Castrelo de Miño
Castrillo	Sp00	Castrillo
Castro	Sp00	Castro
Castroviejo	Sp00	Castroviejo
Cataluña	Sp00	Cataluña
Catarina	Spf0	Catarina
Catedral	Spfs	Catedral
Catharine	Spf0	Catharine
Catharine A. MacKinnon	Spf0	Catharine A. MacKinnon
Catharine Belsey	Spf0	Catharine Belsey
Catharine Deneuve	Spf0	Catharine Deneuve
Catharine Diverrès	Spf0	Catharine Diverrès
Catharine Linton	Spf0	Catharine Linton
Catharine McKinnon	Spf0	Catharine McKinnon
Catoira	Sp00	Catoira
Catpeople	Sp00	Catpeople
Catulo	Spm0	Catulo
Catuxa	Spf0	Catuxa
Cáucaso	Sp00	Cáucaso
Cavalcanti	Sp00	Cavalcanti
Cavallero	Sp00	Cavallero
Cavanna	Sp00	Cavanna
Cazorla	Sp00	Cazorla
Ceapa	Sp00	Ceapa
Ceballos	Sp00	Ceballos
Cebreiro	Sp00	Cebreiro
Cebrián	Sp00	Cebrián
Cecap	Sp00	Cecap
Cecilia Attias	Spf0	Cecilia Attias
Cecilio	Spm0	Cecilio
Cédric Jimenez	Spm0	Cédric Jimenez
Cedrón	Sp00	Cedrón
Cee	Sp00	Cee
Cée	Sp00	Cée
Ceferino	Spm0	Ceferino
Cegrane	Sp00	Cegrane
Celama	Sp00	Celama
Celanova	Sp00	Celanova
Celavella	Sp00	Celavella
Celes	Spm0	Celes
Celestina	Spf0	Celestina
Celestino	Spm0	Celestino
Celia	Spf0	Celia
Celia Villalobos	Spf0	Celia Villalobos
Celina	Spf0	Celina
Celso	Spm0	Celso
Celso Currás	Spm0	Celso Currás
Cenalmor	Sp00	Cenalmor
Cendán Rivas, Xesús	Spm0	Cendán Rivas, Xesús
Central Park	Spms	Central Park
Centro Empresarial do Tambre	Spms	Centro Empresarial do Tambre
Centro Oncolóxico de Galicia	Spms	Centro Oncolóxico de Galicia
Centro de Información de Dereitos Humanos e Movemento Democrático	Spms	Centro de Información de Dereitos Humanos e Movemento Democrático
Centro de Información e Tecnoloxía Ambiental	Spms	Centro de Información e Tecnoloxía Ambiental
Centro de Investigacións Ambientais e Forestais	Spms	Centro de Investigacións Ambientais e Forestais
Centro de Investigacións Enerxéticas Medioambientais e Tecnolóxicas	Spms	Centro de Investigacións Enerxéticas Medioambientais e Tecnolóxicas
Centro de Supercomputación	Spms	Centro de Supercomputación
Centro de Supercomputación de Galicia	Spms	Centro de Supercomputación de Galicia
Centro deInformación e Tecnoloxía Ambiental	Spms	Centro deInformación e Tecnoloxía Ambiental
Centroamérica	Sp00	Centroamérica
Centros	Sp00	Centros
Cerceda	Sp00	Cerceda
Cerdedo	Sp00	Cerdedo
Cerdeña	Sp00	Cerdeña
Cereixido	Sp00	Cereixido
Cerezo	Sp00	Cerezo
Cerf	Sp00	Cerf
Cervantes	Sp00	Cervantes
Cervo	Sp00	Cervo
César	Spm0	César
César Milstein	Spm0	César Milstein
Cesáreo	Spm0	Cesáreo
Ceuta	Sp00	Ceuta
Ch. Baudelaire	Sp00	Ch. Baudelaire
Chabeli	Spf0	Chabeli
Chábeli	Spf0	Chábeli
Chacón	Sp00	Chacón
Chadwick	Sp00	Chadwick
Chaikovski	Sp00	Chaikovski
Chalbaud	Sp00	Chalbaud
Chamorro	Sp00	Chamorro
Chang	Sp00	Chang
Chantada	Sp00	Chantada
Chapela	Sp00	Chapela
Chaplin	Sp00	Chaplin
Chapman	Sp00	Chapman
Charing Cros	Sp00	Charing Cros
Charles	Spm0	Charles
Charles Martin Hall	Spm0	Charles Martin Hall
Charlín	Sp00	Charlín
Charlot	Spf0	Charlot
Charlott Salomon	Spf0	Charlott Salomon
Charlton Heston	Spm0	Charlton Heston
Charo	Spf0	Charo
Charo Álvarez	Spf0	Charo Álvarez
Charo Azcona	Spf0	Charo Azcona
Charo Baleirón	Spf0	Charo Baleirón
Charo Fraga	Spf0	Charo Fraga
Charo Froján	Spf0	Charo Froján
Charo López	Spf0	Charo López
Charo Sánchez	Spf0	Charo Sánchez
Chateaubriend	Spm0	Chateaubriend
Chavarri	Sp00	Chavarri
Chávarri	Sp00	Chávarri
Chavela Vargas	Spf0	Chavela Vargas
Chaves	Sp00	Chaves
Chávez	Sp00	Chávez
Chayanoy	Sp00	Chayanoy
Chbaatu	Sp00	Chbaatu
Chechenia	Sp00	Chechenia
Chechu	Spm0	Chechu
Checoslovaquia	Sp00	Checoslovaquia
Chelo	Spf0	Chelo
Chelo López	Spf0	Chelo López
Chelo Loureiro	Spf0	Chelo Loureiro
Chelo Matesanz	Spf0	Chelo Matesanz
Chelo Mera	Spf0	Chelo Mera
Chelo Suárez	Spf0	Chelo Suárez
Cheney	Sp00	Cheney
Chenoa	Spf0	Chenoa
Cher	Spf0	Cher
Cherie Blair	Spf0	Cherie Blair
Chernomirdin	Sp00	Chernomirdin
Chernormirdin	Sp00	Chernormirdin
Chesterson	Sp00	Chesterson
Chesterson G. K.	Sp00	Chesterson G. K.
Chete Lera	Spm0	Chete Lera
Chete Pazo	Spm0	Chete Pazo
Cheung	Sp00	Cheung
Chevrolet	Sp00	Chevrolet
Chiapa	Sp00	Chiapa
Chiappucci	Sp00	Chiappucci
Chicísimo.com	Sp00	Chicísimo.com
Chick Corea	Spm0	Chick Corea
Chilam Balam	Sp00	Chilam Balam
Chilam Balam	Spm0	Chilam Balam
Chile	Sp00	Chile
China	Sp00	China
Chipman	Sp00	Chipman
Chiqui Barros	Spm0	Chiqui Barros
Chiqui García	Spm0	Chiqui García
Chirac	Sp00	Chirac
Chomsky	Sp00	Chomsky
Chopin	Sp00	Chopin
Chris Bell	Spm0	Chris Bell
Chris Brown	Spm0	Chris Brown
Chris Jones	Spm0	Chris Jones
Chris Skinner	Spm0	Chris Skinner
Chris White	Spm0	Chris White
Chrissie Hynde	Spf0	Chrissie Hynde
Christa Biederbick	Spf0	Christa Biederbick
Christa Wolf	Spf0	Christa Wolf
Christensen	Sp00	Christensen
Christian Bale	Spm0	Christian Bale
Christian Barnard	Spm0	Christian Barnard
Christian Boltanski	Spm0	Christian Boltanski
Christian Dior	Spm0	Christian Dior
Christian Engström	Spm0	Christian Engström
Christian Fernández	Spm0	Christian Fernández
Christian Horner	Spm0	Christian Horner
Christian Kjellvander	Spm0	Christian Kjellvander
Christian Salmon	Spm0	Christian Salmon
Christian Slater	Spm0	Christian Slater
Christian Tisch	Spm0	Christian Tisch
Christiansen	Sp00	Christiansen
Christina	Spf0	Christina
Christoph Mueller	Spm0	Christoph Mueller
Christoph Waltz	Spm0	Christoph Waltz
Christophe Mae	Spm0	Christophe Mae
Christophe Patillon	Spm0	Christophe Patillon
Christopher	Sp00	Christopher
Christopher Britt	Spm0	Christopher Britt
Christopher Caudwell	Spm0	Christopher Caudwell
Christopher Eccleston	Spm0	Christopher Eccleston
Christopher Marlowe	Spm0	Christopher Marlowe
Christopher Mintz-Plasse	Spm0	Christopher Mintz-Plasse
Christopher Nolan	Spm0	Christopher Nolan
Christopher Ohen	Spm0	Christopher Ohen
Christopher Ross	Spm0	Christopher Ross
Christopher Stone	Spm0	Christopher Stone
Chrystyan Magic	Spm0	Chrystyan Magic
Chuck Wald	Spm0	Chuck Wald
Chukri	Sp00	Chukri
Chunta Aragonesista	Sp00	Chunta Aragonesista
Churchill	Sp00	Churchill
Chus Aranguren	Spm0	Chus Aranguren
Chus Baleato	Spm0	Chus Baleato
Chus Gutiérrez	Spf0	Chus Gutiérrez
Chus Lago	Spf0	Chus Lago
Chus Pato	Spf0	Chus Pato
Chus Prol	Spf0	Chus Prol
Ciemar	Spms	Ciemat
Ciemat	Spms	Ciemat
Ciencia Política	Sp00	Ciencia Política
Ciencia e Tecnoloxía de Alimentos	Sp00	Ciencia e Tecnoloxía de Alimentos
Ciencias Actuarias e Financeiras	Sp00	Ciencias Actuarias e Financeiras
Ciencias Económicas e Empresariais	Sp00	Ciencias Económicas e Empresariais
Ciencias Experimentais	Sp00	Ciencias Experimentais
Ciencias Sociais e Xurídicas	Sp00	Ciencias Sociais e Xurídicas
Ciencias de a Conducta	Sp00	Ciencias de a Conducta
Ciencias de a Saúde	Spfp	Ciencias de a Saúde
Cienfuegos	Sp00	Cienfuegos
Cíes	Sp00	Cíes
Cigarrán	Sp00	Cigarrán
Cilenis	Sp00	Cilenis
Cipollini	Sp00	Cipollini
Cipriá Ciscar	Spm0	Cipriá Ciscar
Ciscar	Sp00	Ciscar
Cité de Solèil	Sp00	Cité de Solèil
Citroén	Sp00	Citroén
Citroën	Sp00	Citroën
Citroën C-Cactus	Sp00	Citroën C-Cactus
Citroën C4 Aircross	Sp00	Citroën C4 Aircross
Citroën C4 Grand Picasso	Sp00	Citroën C4 Grand Picasso
Citroën C4 Picasso	Sp00	Citroën C4 Picasso
Citroën DS Faubourg Addict	Sp00	Citroën DS Faubourg Addict
Citroën DS3 Cabrio Racing	Sp00	Citroën DS3 Cabrio Racing
Citroën DS3 Graphic Art	Sp00	Citroën DS3 Graphic Art
Citroën DS4	Sp00	Citroën DS4
Citroën Hispania	Sp00	Citroën Hispania
Citroën Jumpy Atlante Millenium	Sp00	Citroën Jumpy Atlante Millenium
Citroën Nemo	Sp00	Citroën Nemo
Citroën Petit Rosalie	Sp00	Citroën Petit Rosalie
Citroën Racing	Sp00	Citroën Racing
Citroën Tubik	Sp00	Citroën Tubik
Citroën Wild Rubis	Sp00	Citroën Wild Rubis
Ciudad Juárez	Sp00	Ciudad Juárez
Claes	Sp00	Claes
Claire Randall	Spf0	Claire Randall
Clara	Spf0	Clara
Clarins	Sp00	Clarins
Claris Charles	Spf0	Claris Charles
Clark	Sp00	Clark
Clark Kent	Spm0	Clark Kent
Claudette	Spf0	Claudette
Claudio	Spm0	Claudio
Claudio Magris	Spm0	Claudio Magris
Claudio Movilla Álvarez	Spm0	Claudio Movilla Álvarez
Claudio Ptolomeo	Spm0	Claudio Ptolomeo
Claudio Rodríguez Fer	Spm0	Claudio Rodríguez Fer
Claustro	Spms	Claustro
Claustro de Profesores	Spms	Claustro de Profesores
Clayton	Sp00	Clayton
Clément Rosset	Spm0	Clément Rosset
Clemente	Spm0	Clemente
Clemente Jesús Muñiz Guardado	Spm0	Clemente Jesús Muñiz Guardado
Clementina Díez de Baldeón	Spf0	Clementina Díez de Baldeón
Clements	Spm0	Clements
Cleostrata	Spf0	Cleostrata
Cleóstrata	Spf0	Cleóstrata
Clesa	Sp00	Clesa
Cliff	Spm0	Cliff
Cliff Evans	Spm0	Cliff Evans
Clint	Spm0	Clint
Clint Eastwood	Spm0	Clint Eastwood
Clinton	Sp00	Clinton
Clinton-Eltsin	Sp00	Clinton-Eltsin
Clive Owen	Spm0	Clive Owen
Clodio	Spm0	Clodio
Clooney	Sp00	Clooney
Clos	Sp00	Clos
Club	Spms	Club
Club Financeiro de Vigo	Spms	Club Financeiro de Vigo
Coalición Canaria	Sp00	Coalición Canaria
Cobián	Sp00	Cobián
Coby	Sp00	Coby
Cochón	Sp00	Cochón
Código de Conducta Política	Spms	Código de Conducta Política
Coedo	Sp00	Coedo
Cohan	Sp00	Cohan
Cohen	Sp00	Cohen
Coimbra	Sp00	Coimbra
Colette	Spf0	Colette
Colexio Maior Fonseca	Spms	Colexio Maior Fonseca
Colexio Oficial de Arquitectos de Galicia	Spms	Colexio Oficial de Arquitectos de Galicia
"Colexio Público "" Picacho """	Spms	"Colexio Público "" Picacho """
Colexio de Educación Secundaria de San Román de Cervantes	Spms	Colexio de Educación Secundaria de San Román de Cervantes
Colin Arthur	Spm0	Colin Arthur
Colin Blunstone	Spm0	Colin Blunstone
Colin Powell	Spm0	Colin Powell
Coliseo	Spms	Coliseo
Coll	Sp00	Coll
Colmenar	Sp00	Colmenar
Colmenero	Sp00	Colmenero
Coloccini	Sp00	Coloccini
Colom	Sp00	Colom
Colombani	Sp00	Colombani
Colombia	Sp00	Colombia
Colón	Sp00	Colón
Colonia	Sp00	Colonia
Colotto	Sp00	Colotto
Comba	Spf0	Comba
Comba Campoy	Spf0	Comba Campoy
Comercio	Sp00	Comercio
Comesaña	Sp00	Comesaña
Comisión	Spfs	Comisión
Comisión Económica de as Nacións Unidas para Europa	Spfs	Comisión Económica de as Nacións Unidas para Europa
Comisión Especial do Transporte Aéreo de Galicia	Spfs	Comisión Especial do Transporte Aéreo de Galicia
Comisión Europea	Spfs	Comisión Europea
Comisión Executiva do PSdeG-PSOE	Spfs	Comisión Executiva do PSdeG-PSOE
Comisión de Agricultura	Spfs	Comisión de Agricultura
Comisión de Asuntos Xurídicos	Spfs	Comisión de Asuntos Xurídicos
Comisión de Coordinación de a Rexión Norte de Portugal	Spfs	Comisión de Coordinación de a Rexión Norte de Portugal
Comisión de Coordinación e Planificación	Spfs	Comisión de Coordinación e Planificación
Comisión de Directores Xerais de Transportes de Comunidades Autónomas	Spfs	Comisión de Directores Xerais de Transportes de Comunidades Autónomas
Comisión de Industria	Spfs	Comisión de Industria
Comisión de Medio Ambiente	Spfs	Comisión de Medio Ambiente
Comisión de Pesca	Spfs	Comisión de Pesca
Comisión de Sanidade	Spfs	Comisión de Sanidade
Comisión de Transporte Aéreo de Galicia	Spfs	Comisión de Transporte Aéreo de Galicia
Comisiones Obreras	Spms	Comisiones Obreras
Comisións Obreiras	Sp00	Comisións Obreiras
Comité	Spms	Comité
Comité Electoral	Spms	Comité Electoral
Comité Electoral Nacional	Spms	Comité Electoral Nacional
Comité Executivo Nacional do PP	Spms	Comité Executivo Nacional do PP
Comité Nacional	Spms	Comité Nacional
Comité de Estratexia Electoral	Spms	Comité de Estratexia Electoral
Comités Abertos de Escola e Facultade	Spmp	Comités Abertos de Escola e Facultade
Compay	Spm0	Compay
Compay Segundo	Spm0	Compay Segundo
Complexo	Spms	Complexo
Complexo Hospitalario Universitario de Santiago de Compostela	Spms	Complexo Hospitalario Universitario de Santiago de Compostela
Compostela	Sp00	Compostela
Comunicación	Sp00	Comunicación
Comunidade	Spfs	Comunidade
Comunidade Autónoma	Spfs	Comunidade Autónoma
Comunidade Autónoma Basca	Spfs	Comunidade Autónoma Basca
Comunidade Autónoma de Galicia	Spfs	Comunidade Autónoma de Galicia
Comunidade Valenciana	Sp00	Comunidade Valenciana
Comunidade de Madrid	Spfs	Comunidade de Madrid
Comunidade de Traballo	Spfs	Comunidade de Traballo
Comunidade de Traballo Galicia-Norte de Portugal	Spfs	Comunidade de Traballo Galicia-Norte de Portugal
Concello	Spms	Concello
Concello de Caminha	Spms	Concello de Caminha
Concello de Carballedo	Spms	Concello de Carballedo
Concello de Pontevedra	Spms	Concello de Pontevedra
Concello de Vigo	Spms	Concello de Vigo
Concello de a Coruña	Spms	Concello de a Coruña
Concepción	Spf0	Concepción
Concha Blanco	Spf0	Concha Blanco
Concha Costas	Spf0	Concha Costas
Concha Couso Vázquez	Spf0	Concha Couso Vázquez
Concha Fontenla	Spf0	Concha Fontenla
Concha Vales	Spf0	Concha Vales
Concha Velasco	Spf0	Concha Velasco
Conchi	Spf0	Conchi
Conchi Badillo	Spf0	Conchi Badillo
Concilio de Trento	Spms	Concilio de Trento
Condoleezza	Spf0	Condoleezza
Condoleezza Rice	Spf0	Condoleezza Rice
Conducción Segura	Sp00	Conducción Segura
Confapa	Sp00	Confapa
Confapa-Galicia	Sp00	Confapa-Galicia
Confederación Española de Amas de Casa , Consumidores e Usuarios	Spfs	Confederación Española de Amas de Casa , Consumidores e Usuarios
Confederación Española de Centros e Academias Privadas	Spfs	Confederación Española de Centros e Academias Privadas
Confederación Española de Pais de Alumnos	Spfs	Confederación Española de Pais de Alumnos
Confederación Galega de APAs de Centros Públicos	Spfs	Confederación Galega de APAs de Centros Públicos
Confederación Intersindical Galega	Spfs	Confederación Intersindical Galega
Confederación Nacional de Autoescolas	Spfs	Confederación Nacional de Autoescolas
Confederación de Empresarios de Pontevedra	Spfs	Confederación de Empresarios de Pontevedra
Confederación de Nacementos Múltiples	Spfs	Confederación de Nacementos Múltiples
Conferencia de Madrid	Spfs	Conferencia de Madrid
Congreso	Spms	Congreso
Congreso Nacional de Cirurxía Pediátrica	Spms	Congreso Nacional de Cirurxía Pediátrica
Congreso dos Deputados	Spms	Congreso dos Deputados
Congreso nacional de a Sociedade Española do Xeonllo	Spms	Congreso nacional de a Sociedade Española do Xeonllo
Connery	Sp00	Connery
Conrad	Spm0	Conrad
Conrad Ensenyat	Spm0	Conrad Ensenyat
Conrad Hilton	Spm0	Conrad Hilton
Conrad Song	Spm0	Conrad Song
Consellería	Spfs	Consellería
Consellería de Agricultura , Gandería e Política Agroalimentaria	Spfs	Consellería de Agricultura , Gandería e Política Agroalimentaria
Consellería de Cultura	Spfs	Consellería de Cultura
Consellería de Cultura , Comunicación Social e Turismo	Spfs	Consellería de Cultura , Comunicación Social e Turismo
Consellería de Cultura Comunicación Social e Turismo	Spfs	Consellería de Cultura Comunicación Social e Turismo
Consellería de Economía e Facenda	Spfs	Consellería de Economía e Facenda
Consellería de Educación	Spfs	Consellería de Educación
Consellería de Educación e Ordenación Universitaria	Spfs	Consellería de Educación e Ordenación Universitaria
Consellería de Familia	Spfs	Consellería de Familia
Consellería de Familia e Promoción do Emprego	Spfs	Consellería de Familia e Promoción do Emprego
Consellería de Familia e Promoción do Emprego , Muller	Spfs	Consellería de Familia e Promoción do Emprego , Muller
Consellería de Familia e Promoción do Emprego , Muller e Xuventude	Spfs	Consellería de Familia e Promoción do Emprego , Muller e Xuventude
Consellería de Industria	Spfs	Consellería de Industria
Consellería de Industria e Comercio	Spfs	Consellería de Industria e Comercio
Consellería de Medio Ambiente	Spfs	Consellería de Medio Ambiente
Consellería de Pesca	Spfs	Consellería de Pesca
Consellería de Política Territorial	Spfs	Consellería de Política Territorial
Consellería de Política Territorial , Obras Públicas e Vivenda	Spfs	Consellería de Política Territorial , Obras Públicas e Vivenda
Consellería de Presidencia e Administración Pública	Spfs	Consellería de Presidencia e Administración Pública
Consellería de Sanidade	Spfs	Consellería de Sanidade
Consellería de Sanidade e Asuntos Sociais	Spfs	Consellería de Sanidade e Asuntos Sociais
Consellería de Sanidade e Servicios Sociais	Spfs	Consellería de Sanidade e Servicios Sociais
Consellería de Xustiza , Interior e Relacións Laborais	Spfs	Consellería de Xustiza , Interior e Relacións Laborais
Consellería de a Presidencia e Administración Pública	Spfs	Consellería de a Presidencia e Administración Pública
Consello	Spms	Consello
Consello Asesor de Medio Ambiente	Spms	Consello Asesor de Medio Ambiente
Consello Atlántico	Spms	Consello Atlántico
Consello Central	Spms	Consello Central
Consello Económico e Social	Spms	Consello Económico e Social
Consello Nacional	Spm0	Consello Nacional
Consello Político	Spms	Consello Político
Consello Pontifical de a Cultura	Spm0	Consello Pontifical de a Cultura
Consello Regulador do Mexillón	Spms	Consello Regulador do Mexillón
Consello Social	Spms	Consello Social
Consello Superior de Cámaras	Spms	Consello Superior de Cámaras
Consello Superior de Cámaras de Comercio	Spms	Consello Superior de Cámaras de Comercio
Consello Superior do Audiovisual	Spms	Consello Superior do Audiovisual
Consello Xeral do Poder Xudicial	Spms	Consello Xeral do Poder Xudicial
Consello de Administración de Paradores de Turismo de España	Spms	Consello de Administración de Paradores de Turismo de España
Consello de Ministros	Spms	Consello de Ministros
Consello de Ministros de Cuba	Spms	Consello de Ministros de Cuba
Consello de Ministros de Economía e Finanzas	Spms	Consello de Ministros de Economía e Finanzas
Consello de Ministros de a República de Cuba	Spms	Consello de Ministros de a República de Cuba
Consello de Seguridade	Spms	Consello de Seguridade
Consello de Seguridade Nacional	Spms	Consello de Seguridade Nacional
Consello de Seguridade de a ONU	Spms	Consello de Seguridade de a ONU
Consello de Universidades	Spms	Consello de Universidades
Consello de a Cultura	Spms	Consello de a Cultura
Consello de a Cultura Galega	Spms	Consello de a Cultura Galega
Consello de a Federación	Spms	Consello de a Federación
Consello de a Xunta de Galicia	Spms	Consello de a Xunta de Galicia
Consolación	Spf0	Consolación
Constancio	Spm0	Constancio
Constante	Spm0	Constante
Constantino	Spm0	Constantino
Constantinopla	Sp00	Constantinopla
Constanza Tobío	Spf0	Constanza Tobío
Constanza de Castro	Spf0	Constanza de Castro
Constenla	Sp00	Constenla
Constitución	Spfs	Constitución
Constitucional	Spms	Constitucional
Consum	Sp00	Consum
Contigo	Spms	Contigo
Convención de Xenebra	Spfs	Convención de Xenebra
Convergencia i Unió	Sp00	Convergencia i Unió
Conway	Sp00	Conway
Conxo	Sp00	Conxo
Cook	Sp00	Cook
Cooperativa	Spfs	Cooperativa
Cooperativa de Armadores de Vigo	Spfs	Cooperativa de Armadores de Vigo
Cooperativa de Vigo	Spfs	Cooperativa de Vigo
Coordinación	Sp00	Coordinación
Coordinación e Avaliación Asistencial	Sp00	Coordinación e Avaliación Asistencial
Copena	Sp00	Copena
Copenhagen Dreams	Sp00	Copenhagen Dreams
Copernicus	Sp00	Copernicus
Coppini	Sp00	Coppini
Coppola	Sp00	Coppola
Córdoba	Sp00	Córdoba
Córdova	Sp00	Córdova
Cordovani	Sp00	Cordovani
Coremain	Sp00	Coremain
Coridón	Sp00	Coridón
Corín Tellado	Spf0	Corín Tellado
Corina	Spf0	Corina
Corina Porro	Spf0	Corina Porro
Corinna	Spf0	Corinna
Cormac McCarthy	Spm0	Cormac McCarthy
Cornejo	Sp00	Cornejo
Cornelia	Spf0	Cornelia
Cornelia Tinica	Spf0	Cornelia Tinica
Cornell	Sp00	Cornell
Cornell University Medical	Spfs	Cornell University Medical
Cornellà	Sp00	Cornellà
Corpo Nacional de Policía	Spms	Corpo Nacional de Policía
Corpo de Xestión	Spms	Corpo de Xestión
Corral	Sp00	Corral
Correlingua	Sp00	Correlingua
Correos	Spmp	Correos
Cortázar	Sp00	Cortázar
Corte Suprema	Spfs	Corte Suprema
Cortegada	Sp00	Cortegada
Cortes Xerais	Spfp	Cortes Xerais
Coruña	Sp00	Coruña
Cosculluela	Sp00	Cosculluela
Cosmers Kemboi	Spm0	Cosmers Kemboi
Cospedal	Sp00	Cospedal
Cospeito	Sp00	Cospeito
Costa de a Morte	Spfs	Costa de a Morte
Cotogrande	Sp00	Cotogrande
Couceiro	Sp00	Couceiro
Covadonga	Sp00	Covadonga
Covadonga Berdiñas	Spf0	Covadonga Berdiñas
Covelo	Sp00	Covelo
Coward	Sp00	Coward
Cox	Sp00	Cox
Craig Newmark	Spm0	Craig Newmark
Craig Patterson	Spm0	Craig Patterson
Craig Werner	Spm0	Craig Werner
Crat Xestur	Sp00	Crat Xestur
Craviotto	Sp00	Craviotto
Crawlersout	Sp00	Crawlersout
Craxi	Sp00	Craxi
Crebinsky	Sp00	Crebinsky
Creonte	Spm0	Creonte
Creus	Sp00	Creus
Cristi	Spf0	Cristi
Cristina	Spf0	Cristina
Cristina García Orcoyen	Spf0	Cristina García Orcoyen
Cristina Gutiérrez	Spf0	Cristina Gutiérrez
Cristo	Spm0	Cristo
Cristóbal	Spm0	Cristóbal
Crivillé	Sp00	Crivillé
Crnac	Sp00	Crnac
Croacia	Sp00	Croacia
Cruces	Sp00	Cruces
Cruxeira	Sp00	Cruxeira
Cruyff	Sp00	Cruyff
Cruz Vermella	Sp00	Cruz Vermella
Cruz Vermella	Spfs	Cruz Vermella
Cuace Arriba	Sp00	Cuace Arriba
Cualedro	Sp00	Cualedro
Cuartel Supremo Aliado	Spms	Cuartel Supremo Aliado
Cuarto do Comandante	Sp00	Cuarto do Comandante
Cuba	Sp00	Cuba
Cuco Pérez	Spm0	Cuco Pérez
Cudeiro	Sp00	Cudeiro
Cuéllar	Sp00	Cuéllar
Cuervo	Sp00	Cuervo
Cuesta	Sp00	Cuesta
Cuevillas	Sp00	Cuevillas
Cuíña	Sp00	Cuíña
Cuíña Crespo	Sp00	Cuíña Crespo
Culla	Sp00	Culla
Cullell	Sp00	Cullell
Culleredo	Sp00	Culleredo
Cultura	Sp00	Cultura
Cumberbatch	Sp00	Cumberbatch
Cumio de Berlín	Spms	Cumio de Berlín
Cunningham	Sp00	Cunningham
Cunqueiro	Sp00	Cunqueiro
Cuntis	Sp00	Cuntis
Curdistán	Sp00	Curdistán
Curiel	Sp00	Curiel
Curran	Sp00	Curran
Currey	Sp00	Currey
Curri Valenzuela	Spf0	Curri Valenzuela
Curros	Sp00	Curros
Curros Enriquez	Sp00	Curros Enriquez
Curtis	Sp00	Curtis
D. Beaumont	Sp00	D. Beaumont
Dadik	Spm0	Dadik
Damián	Spm0	Damián
Damián Villalaín	Spm0	Damián Villalaín
Dan	Spm0	Dan
Daniel	Spm0	Daniel
Daniele Da Volterra	Spm0	Daniele Da Volterra
Danilo Manera	Spm0	Danilo Manera
Danilo Martuccelli	Spm0	Danilo Martuccelli
Darío	Spm0	Darío
Dario Fo	Spm0	Dario Fo
Darío Villanueva	Spm0	Darío Villanueva
Dario Xohán Cabana	Spm0	Dario Xohán Cabana
Das ausencias I	Sp00	Das ausencias I
David	Spm0	David
David Boies	Spm0	David Boies
David Ferrer Valeiras	Spm0	David Ferrer Valeiras
David Leavy	Spm0	David Leavy
David Maceiras Subiela	Spm0	David Maceiras Subiela
David Martínez	Spm0	David Martínez
David Trimble	Spm0	David Trimble
De Palacio	Sp00	De Palacio
De la Cerda	Sp00	De la Cerda
Debate sobre o Estado de a Nación	Spms	Debate sobre o Estado de a Nación
Decena de a Música	Spfs	Decena de a Música
Declaración de Canarias	Spfs	Declaración de Canarias
Decreto 12/1994	Spms	Decreto 12/1994
Decreto 42/1998	Spms	Decreto 42/1998
Decreto 89/1997	Spms	Decreto 89/1997
Dédalo	Sp00	Dédalo
Defensa	Sp00	Defensa
Defensa Civil	Spfs	Defensa Civil
Defensor de el Pueblo	Spms	Defensor de el Pueblo
Delegación	Spfs	Delegación
Delegación Provincial	Spfs	Delegación Provincial
Delegación Provincial de a Consellería de Educación	Spfs	Delegación Provincial de a Consellería de Educación
Delia	Spf0	Delia
Delio	Spm0	Delio
Delmiro	Spm0	Delmiro
Delta	Sp00	Delta
Demetrio	Spm0	Demetrio
Democracia Galega	Sp00	Democracia Galega
Demoscopia	Sp00	Demoscopia
Denís	Spm0	Denís
Departamento Electoral	Spms	Departamento Electoral
Departamento Xurídico do Ministerio español de Exterior	Spms	Departamento Xurídico do Ministerio español de Exterior
Departamento de Actividades e Servicios de Cruz Vermella Española	Spms	Departamento de Actividades e Servicios de Cruz Vermella Española
Departamento de Dereito Romano	Sp00	Departamento de Dereito Romano
Departamento de Literatura Española	Spms	Departamento de Literatura Española
Departamento de Microbioloxía e Parasitoloxía	Spms	Departamento de Microbioloxía e Parasitoloxía
Departamento de Xustiza	Spms	Departamento de Xustiza
Deputación	Spfs	Deputación
Deputación Provincial	Spfs	Deputación Provincial
Deputación Provincial de Ourense	Spfs	Deputación Provincial de Ourense
Deputación de Araba	Spfs	Deputación de Araba
Deputación de Cáceres	Spfs	Deputación de Cáceres
Deputación de a Coruña	Spfs	Deputación de a Coruña
Dereito	Sp00	Dereito
Dereitos Humanos	Spmp	Dereitos Humanos
Derek van der Bogaerde	Spm0	Derek van der Bogaerde
Derry	Sp00	Derry
Desiderio	Spm0	Desiderio
Despedida de solteiro	Sp00	Despedida de solteiro
Deus	Spm0	Deus
Día Internacional do Traballador	Spms	Día Internacional do Traballador
Día de Europa	Spms	Día de Europa
Día de a Santa Cruz	Spms	Día de a Santa Cruz
Día de as Letras Galegas	Sp00	Día de as Letras Galegas
Día de as Letras Galegas	Spms	Día de as Letras Galegas
Día do Traballo	Spms	Día do Traballo
Día mundial sen tabaco	Spms	Día mundial sen tabaco
Día sen Televisión	Spms	Día sen Televisión
Diagnóstico	Sp00	Diagnóstico
Diamantina	Spf0	Diamantina
Diamantino	Spm0	Diamantino
Diana	Spf0	Diana
Diario Oficial	Sp00	Diario Oficial
Diario Oficial de Galicia	Sp00	Diario Oficial de Galicia
Diario Oficial de Galicia	Spms	Diario Oficial de Galicia
Díaz	Sp00	Díaz
Díaz Barreto	Sp00	Díaz Barreto
Díaz Castañeiro	Sp00	Díaz Castañeiro
Díaz Castro	Sp00	Díaz Castro
Díaz Conde	Sp00	Díaz Conde
Díaz Díaz	Sp00	Díaz Díaz
Díaz Díaz, Gabriel	Spm0	Díaz Díaz, Gabriel
Díaz Ferrán	Sp00	Díaz Ferrán
Díaz Güell	Sp00	Díaz Güell
Díaz Noriega	Sp00	Díaz Noriega
Díaz Palafox	Sp00	Díaz Palafox
Díaz Pardo	Sp00	Díaz Pardo
Díaz Porleir, Xohán	Spm0	Díaz Porleir, Xohán
Díaz Raña	Sp00	Díaz Raña
Díaz Tezanos	Sp00	Díaz Tezanos
Díaz Usabiaga	Sp00	Díaz Usabiaga
Díaz de Castro	Sp00	Díaz de Castro
Díaz de Freijo	Sp00	Díaz de Freijo
Díaz de Revenga	Sp00	Díaz de Revenga
Díaz, Filomena	Spf0	Díaz, Filomena
Dick Bogarde	Spm0	Dick Bogarde
Die Woche	Sp00	Die Woche
Diego	Spm0	Diego
Diego Bernal	Spm0	Diego Bernal
Diego Rodríguez	Spm0	Diego Rodríguez
Diego Vela	Spm0	Diego Vela
Diéguez	Sp00	Diéguez
Diéguez Fernández, Xosé	Spm0	Diéguez Fernández, Xosé
Dieste	Sp00	Dieste
Díez	Sp00	Díez
Díez Alegría	Sp00	Díez Alegría
Díez Usabiaga	Sp00	Díez Usabiaga
Dimitris Reppas	Spm0	Dimitris Reppas
Dinamarca	Sp00	Dinamarca
Dinkic	Sp00	Dinkic
Dirección Xeral XIV de Pesca de a UE	Spfs	Dirección Xeral XIV de Pesca de a UE
Dirección Xeral de Estructuras Pesqueiras	Spfs	Dirección Xeral de Estructuras Pesqueiras
Dirección Xeral de Persoal	Spfs	Dirección Xeral de Persoal
Dirección Xeral de Tráfico	Spfs	Dirección Xeral de Tráfico
Dirección Xeral de Turismo	Spfs	Dirección Xeral de Turismo
Dirk Bogarde	Spm0	Dirk Bogarde
Distro e do outro	Sp00	Distro e do outro
Divinas Palabras	Sp00	Divinas Palabras
División Territorial de Caixa Galicia	Spfs	División Territorial de Caixa Galicia
Djakovica	Sp00	Djakovica
Docampo	Sp00	Docampo
Dolce&Gabbana	Sp00	Dolce&Gabbanna
Dolores Rodríguez Núñez	Spf0	Dolores Rodríguez Núñez
Dolores Villarino	Spf0	Dolores Villarino
Dominga	Spf0	Dominga
Domingo Docampo	Spm0	Domingo Docampo
Domínguez	Sp00	Domínguez
Domínguez Carmona, Manuel	Spm0	Domínguez Carmona, Manuel
Domínguez Fernández	Sp00	Domínguez Fernández
Domínguez Ferreira, Xoaquín	Spm0	Domínguez Ferreira, Xoaquín
Domínguez Olveira	Sp00	Domínguez Olveira
Dominique Strauss-Kahn	Spm0	Dominique Strauss-Kahn
Dominó do Camiño	Spms	Dominó do Camiño
Dominó do Camiño de Santiago	Spms	Dominó do Camiño de Santiago
Donald Dewar	Spm0	Donald Dewar
Donald Pleasance	Spm0	Donald Pleasance
Donald Rumsfeld	Spm0	Donald Rumsfeld
Donald Shelbourne	Spm0	Donald Shelbourne
Donald Trump	Spm0	Donald Trump
Doñana	Sp00	Doñana
Donatiño	Spm0	Donatiño
Donato	Spm0	Donato
Doncela guerreira	Spfs	Doncela guerreira
Dores	Spf0	Dores
Dorinda	Spf0	Dorinda
Dorotea	Spf0	Dorotea
Dosinda	Spf0	Dosinda
Dositeo Rodríguez	Spm0	Dositeo Rodríguez
Dostoievski	Spm0	Dostoievski
Doutor TNT	Spms	Doutor TNT
Downing Street	Sp00	Downing Street
Dragana Dimic	Spf0	Dragana Dimic
Duarte	Spm0	Duarte
Dublín	Sp00	Dublín
Dulutz	Sp00	Dulutz
Duma	Spfs	Duma
Dumia	Spf0	Dumia
Durres	Sp00	Durres
Dusan Matkovic	Spm0	Dusan Matkovic
Dusseldorf	Sp00	Dusseldorf
E. Wilson	Sp00	E. Wilson
Ecequiel	Spm0	Ecequiel
Echávarri	Sp00	Echávarri
Echegaray	Sp00	Echegaray
Eco de Moscova	Spfs	Eco de Moscova
Ecofín	Sp00	Ecofín
Ecoloxistas en Acción	Sp00	Ecoloxistas en Acción
Economía	Sp00	Economía
Ecovidro	Sp00	Ecovidro
Ecuador	Sp00	Ecuador
Eddy Merckx	Spm0	Eddy Merckx
Edelmiro	Spm0	Edelmiro
Edgar Morin	Spm0	Edgar Morin
Edimburgo	Sp00	Edimburgo
Edite	Spf0	Edite
Editorial Galaxia	Sp00	Editorial Galaxia
Edmundo	Spm0	Edmundo
Eduardo	Spm0	Eduardo
Eduardo Serra	Spm0	Eduardo Serra
Eduardo Zaplana	Spm0	Eduardo Zaplana
Educación	Sp00	Educación
Educación , Universidades , Investigación e Desenvolvemento	Sp00	Educación , Universidades , Investigación e Desenvolvemento
Educación Infantil	Sp00	Educación Infantil
Educación e Cultura	Sp00	Educación e Cultura
Educación e Ordenación Universitaria	Sp00	Educación e Ordenación Universitaria
Efe	Sp00	Efe
Egibar	Sp00	Egibar
Ehud Barak	Sp00	Ehud Barak
Ehud Barak	Spm0	Ehud Barak
Einstein	Sp00	Einstein
Ejército Popular de Liberación	Spms	Ejército Popular de Liberación
El Correo	Spms	El Correo
El Correo Gallego	Spms	El Correo Gallego
El Mundo Digital	Spms	El Mundo Digital
El País	Spms	El País
El País Digital	Spms	El País Digital
El Pulpo	Sp00	El Pulpo
Eladio	Spm0	Eladio
Eladio Capón	Spm0	Eladio Capón
Eleazar	Spm0	Eleazar
Elena	Spf0	Elena
Elena Pisonera	Spf0	Elena Pisonera
Eleuterio	Spm0	Eleuterio
Elías	Spm0	Elías
Elisa	Spf0	Elisa
Elisa Fernández de la Vega	Spf0	Elisa Fernández de la Vega
Eliseo	Spm0	Eliseo
Eliseu	Spm0	Eliseu
Elliot	Sp00	Elliot
Eloi	Spm0	Eloi
Eloy	Spm0	Eloy
Eloy Cambón	Spm0	Eloy Cambón
Eloy Domínguez	Spm0	Eloy Domínguez
Eloy Domínguez Serén	Spm0	Eloy Domínguez Serén
Eloy Enciso	Spm0	Eloy Enciso
Eloy Gutiérrez Menoyo	Spm0	Eloy Gutiérrez Menoyo
Eloy Lozano	Spm0	Eloy Lozano
Eloy Ramil	Spm0	Eloy Ramil
Eloy Rodríguez	Spm0	Eloy Rodríguez
Eloy Sánchez Rosillo	Spm0	Eloy Sánchez Rosillo
Eloy Velasco	Spm0	Eloy Velasco
Elpidio	Spm0	Elpidio
Eltsin	Spfs	Eltsin
Elviña	Sp00	Elviña
Elvira	Spf0	Elvira
Elvis	Spm0	Elvis
Embaixada	Spfs	Embaixada
Embaixada de Australia	Spfs	Embaixada de Australia
Emigración a a fin do mundo	Sp00	Emigración a a fin do mundo
Emilia	Spf0	Emilia
Emiliano Navajas	Spm0	Emiliano Navajas
Emilio	Spm0	Emilio
Emilio Cagiao	Spm0	Emilio Cagiao
Emilio Cagio	Spm0	Emilio Cagio
Emilio Pérez Touriño	Spm0	Emilio Pérez Touriño
Emprego	Sp00	Emprego
Empresa Nacional Bazán	Spfs	Empresa Nacional Bazán
Empresa Nacional de Electricidad , SA	Spfs	Empresa Nacional de Electricidad , SA
En clave de folk	Sp00	En clave de folk
Encarna Otero	Spf0	Encarna Otero
Endesa	Sp00	Endesa
Engels	Sp00	Engels
Enoloxía	Sp00	Enoloxía
Enquisa de Poboación Activa	Spfs	Enquisa de Poboación Activa
Enrique	Spm0	Enrique
Enrique Fernández	Spm0	Enrique Fernández
Enrique Mariñas	Sp00	Enrique Mariñas
Enrique Mariñas	Spm0	Enrique Mariñas
Enrique Sotelo	Spm0	Enrique Sotelo
Enrique Sotelo Villar	Spm0	Enrique Sotelo Villar
Enriqueta	Spf0	Enriqueta
Enríquez	Sp00	Enríquez
Enríquez Domínguez	Sp00	Enríquez Domínguez
Enríquez Rodríguez	Sp00	Enríquez Rodríguez
Ensino Secundario Obrigatorio	Sp00	Ensino Secundario Obrigatorio
Entrerrúas	Sp00	Entrerrúas
Enud Gol	Spm0	Enud Gol
Enud Golp	Spm0	Enud Golp
Enxeñería Química	Sp00	Enxeñería Química
Episodio 1	Sp00	Episodio 1
Episodio 1 . A ameaza fantasma	Sp00	Episodio 1 . A ameaza fantasma
Equipamento	Sp00	Equipamento
Erasmus	Sp00	Erasmus
Erdmann	Sp00	Erdmann
Erias	Sp00	Erias
Erik Asbrink	Spm0	Erik Asbrink
Ermesinda	Spf0	Ermesinda
Ernestina Marelli	Spf0	Ernestina Marelli
Ernesto	Spm0	Ernesto
Ernesto Augusto de Hannover	Spm0	Ernesto Augusto de Hannover
Ernesto Gómez	Spm0	Ernesto Gómez
Ernesto de Aguiar	Spm0	Ernesto de Aguiar
Ero	Spm0	Ero
Eros Ramazzotti	Spm0	Eros Ramazzotti
Eroski	Sp00	Eroski
Ertzaintza	Spfs	Ertzaintza
Escobar	Sp00	Escobar
Escocia	Sp00	Escocia
Escola Galega de Administración Pública	Spfs	Escola Galega de Administración Pública
Escola Oficial de Turismo	Spfs	Escola Oficial de Turismo
Escola Superior de Hostelería	Spfs	Escola Superior de Hostelería
Escola Técnica Superior de Arquitectura	Spfs	Escola Técnica Superior de Arquitectura
Escola Universitaria de Arquitectos Técnicos	Spfs	Escola Universitaria de Arquitectos Técnicos
Escola de Artes e Imaxe	Spfs	Escola de Artes e Imaxe
Escola de Hostelería	Spfs	Escola de Hostelería
Escravitude	Spf0	Escravitude
Esmelle	Sp00	Esmelle
España	Sp00	España
Espí	Sp00	Espí
Espí Martínez	Sp00	Espí Martínez
Esquerda de Galicia	Sp00	Esquerda de Galicia
Estaçãou	Sp00	Estaçãou
Estación Depuradora de San Vicente do Mar	Spfs	Estación Depuradora de San Vicente do Mar
Estado	Spms	Estado
Estado Maior de a Armada	Spms	Estado Maior de a Armada
Estado de Cooperación Internacional	Sp00	Estado de Cooperación Internacional
Estado de Facenda	Sp00	Estado de Facenda
Estado de Israel	Spms	Estado de Israel
Estados Unidos	Sp00	Estados Unidos
Estanislao	Spm0	Estanislao
Estatuto de Gernika	Spms	Estatuto de Gernika
Esteban	Spm0	Esteban
Esteban Beltrán	Spm0	Esteban Beltrán
Estefanía	Spf0	Estefanía
Esteiro	Sp00	Esteiro
Ester	Spf0	Ester
Estévez	Sp00	Estévez
Estevo	Spm0	Estevo
Esther	Spf0	Esther
Esther Arcas	Spf0	Esther Arcas
Estrasburgo	Sp00	Estrasburgo
Estrela	Spf0	Estrela
Estrella Rodríguez	Spf0	Estrella Rodríguez
Estremadura	Sp00	Estremadura
Etelvina	Spf0	Etelvina
Etelvino	Spm0	Etelvino
Etiopía	Sp00	Etiopía
Eugenio Riobó	Spm0	Eugenio Riobó
Eulalia	Spf0	Eulalia
Euloxio	Spm0	Euloxio
Euro Disney	Sp00	Euro Disney
Euro-Efecto 2000	Sp00	Euro-Efecto 2000
Eurocámara	Spfs	Eurocámara
Europa	Sp00	Europa
Europa Press	Sp00	Europa Press
Europa Press Televisión	Sp00	Europa Press Televisión
Eurozona	Spfs	Eurozona
Euscadi	Sp00	Euscadi
Eusebio	Spm0	Eusebio
Euskal Herria	Sp00	Euskal Herria
Euskal Herría	Sp00	Euskal Herría
Euskal Herritarrok	Sp00	Euskal Herritarrok
Eutimio Arias	Spm0	Eutimio Arias
Euxenia	Spf0	Euxenia
Euxenio	Spm0	Euxenio
Eva	Spf0	Eva
Eva María	Spf0	Eva María
Evans Mayoyo	Spm0	Evans Mayoyo
Evaristo	Spm0	Evaristo
Evgueni Primakov	Spm0	Evgueni Primakov
Executiva	Spfs	Executiva
Executiva Federal	Spfs	Executiva Federal
Executivo	Spms	Executivo
Exército	Spms	Exército
Exército Republicano Irlandés	Spms	Exército Republicano Irlandés
Exército de Liberación de Kósovo	Spms	Exército de Liberación de Kósovo
Exército do Aire	Spms	Exército do Aire
Exército do Sur do Líbano	Spms	Exército do Sur do Líbano
Exipto	Sp00	Exipto
Explorer	Spms	Explorer
Exteriores	Sp00	Exteriores
Ezra Furman	Spm0	Ezra Furman
Ezra Moreno	Spm0	Ezra Moreno
Ezra Pound	Spm0	Ezra Pound
F-15E	Sp00	F-15E
F-16	Spms	F-16
FEOGA-Garantía	Sp00	FEOGA-Garantía
FIA-Pontevedra	Sp00	FIA-Pontevedra
Fabiano	Spm0	Fabiano
Fabiola Olivieri	Spf0	Fabiola Olivieri
Fabiola Sotelo	Spf0	Fabiola Sotelo
Fabiola Sotelo Blanco	Spf0	Fabiola Sotelo Blanco
Fábrica de Tabacos	Spfs	Fábrica de Tabacos
Facebook	Sp00	Facebook
Facenda	Sp00	Facenda
Facenda	Spfs	Facenda
Facilisimo.com	Sp00	Facilisimo.com
Facultade de Ciencias Económicas e Empresariais	Spfs	Facultade de Ciencias Económicas e Empresariais
Facultade de Ciencias Sociais	Spfs	Facultade de Ciencias Sociais
Facultade de Económicas	Spfs	Facultade de Económicas
Facultade de Educación	Spfs	Facultade de Educación
Facultade de Humanidades	Spfs	Facultade de Humanidades
Facultade de Medicina	Spfs	Facultade de Medicina
Facultade de Medicina e Odontoloxía	Spfs	Facultade de Medicina e Odontoloxía
Familia	Sp00	Familia
Familia , Muller e Xuventude	Sp00	Familia , Muller e Xuventude
Fandiño	Sp00	Fandiño
Fandiño	Spm0	Fandiño
Fanto	Spm0	Fanto
Farruco	Spm0	Farruco
Farruquiño	Sp00	Farruquiño
Farto	Sp00	Farto
Faustino	Spm0	Faustino
Fdez. Ordóñez	Sp00	Fdez. Ordóñez
Feáns	Sp00	Feáns
Federación	Spfs	Federación
Federación Galega de Autoescolas	Spfs	Federación Galega de Autoescolas
Federación Galega de Parques Empresariais	Spfs	Federación Galega de Parques Empresariais
Federación Ibérica de Asociacións de Telespectadores e Radioíntes	Spfs	Federación Ibérica de Asociacións de Telespectadores e Radioíntes
Federación Nacional	Spfs	Federación Nacional
Federación Nacional de Asociacións de Familias de Xemelgos	Spfs	Federación Nacional de Asociacións de Familias de Xemelgos
Federación Nacional de Cofradías de Pescadores	Spfs	Federación Nacional de Cofradías de Pescadores
Federación de Industrias Afíns	Spfs	Federación de Industrias Afíns
Federer	Sp00	Federer
Federico	Spm0	Federico
Federico Mayor Zaragoza	Spm0	Federico Mayor Zaragoza
Fefiga	Sp00	Fefiga
Fegape	Sp00	Fegape
Fegas	Sp00	Fegas
Fehmi Agani	Spm0	Fehmi Agani
Feijoo	Sp00	Feijoo
Feijóo	Sp00	Feijóo
Feira Europea de Simulación	Spfs	Feira Europea de Simulación
Feira Internacional Semana Verde de Galicia	Spfs	Feira Internacional Semana Verde de Galicia
Feira Internacional de Galicia	Sp00	Feira Internacional de Galicia
Feira de Turismo de Cataluña	Spfs	Feira de Turismo de Cataluña
Feiras e Festas de Galicia	Sp00	Feiras e Festas de Galicia
Feixó	Sp00	Feixó
Feixoo	Sp00	Feixoo
Feixóo	Sp00	Feixóo
Feliciano	Spm0	Feliciano
Felipe	Spm0	Felipe
Felipe González	Spm0	Felipe González
Felipe Ruiz	Spm0	Felipe Ruiz
Felisa	Spf0	Felisa
Félix	Spm0	Félix
Félix Ormazábal	Spm0	Félix Ormazábal
Fermín	Spm0	Fermín
Fermín Díaz	Spm0	Fermín Díaz
Fernán Gómez	Sp00	Fernán Gómez
Fernán López de Lemos	Spm0	Fernán López de Lemos
Fernán Mourenza	Sp00	Fernán Mourenza
Fernanda	Spf0	Fernanda
Fernandes	Sp00	Fernandes
Fernández	Sp00	Fernández
Fernández Álvarez	Sp00	Fernández Álvarez
Fernández Lores	Sp00	Fernández Lores
Fernández Reinosa	Sp00	Fernández Reinosa
Fernando	Spm0	Fernando
Fernando Espí Martínez	Spm0	Fernando Espí Martínez
Fernando Garea	Spm0	Fernando Garea
Fernando Jáuregui	Spm0	Fernando Jáuregui
Fernando Jiménez Herrero	Spm0	Fernando Jiménez Herrero
Fernando Rodríguez	Spm0	Fernando Rodríguez
Fernando Villalonga	Spm0	Fernando Villalonga
Ferrán Adriá	Spm0	Ferrán Adriá
Ferrán Martínez	Spm0	Ferrán Martínez
Ferrán Pujol	Spm0	Ferrán Pujol
Ferreiro	Sp00	Ferreiro
Ferro	Sp00	Ferro
Ferrol	Sp00	Ferrol
Ferrol-Betanzos	Sp00	Ferrol-Betanzos
Ferrolterra	Sp00	Ferrolterra
Festa do Capón	Spfs	Festa do Capón
Fiatex	Sp00	Fiatex
Fiatex	Spms	Fiatex
Fiatyr	Sp00	Fiatyr
Fidel Castro	Spm0	Fidel Castro
Figueiras	Sp00	Figueiras
Figueirido	Sp00	Figueirido
Filgueira	Sp00	Filgueira
Filgueira Valverde	Sp00	Filgueira Valverde
Filharmonía	Spfs	Filharmonía
Filipe	Spm0	Filipe
Filmax	Sp00	Filmax
Filócrates	Spm0	Filócrates
Filomena	Spf0	Filomena
Filosofía	Sp00	Filosofía
Fina	Spf0	Fina
Finanzas	Sp00	Finanzas
Finlandia	Sp00	Finlandia
Firmino	Spm0	Firmino
Fiscalía	Spfs	Fiscalía
Fiscalía Anticorrupción	Spfs	Fiscalía Anticorrupción
Fisioloxía	Sp00	Fisioloxía
Fisterra	Sp00	Fisterra
Flora	Spf0	Flora
Florencio Arce	Spm0	Florencio Arce
Florentina	Spf0	Florentina
Florentino	Spm0	Florentino
Florida	Sp00	Florida
Florisel	Spm0	Florisel
Folchi	Sp00	Folchi
Fomento	Sp00	Fomento
Fondo Monetario Internacional	Spms	Fondo Monetario Internacional
Fondo Social Europeo	Spms	Fondo Social Europeo
Fonseca	Sp00	Fonseca
Fonso	Spm0	Fonso
Ford	Sp00	Ford
Ford España	Sp00	Ford España
Ford Madox Ford	Sp00	Ford Madox Ford
Formación	Sp00	Formación
Formación Profesional	Spfs	Formación Profesional
Fornelos de Montes	Sp00	Fornelos de Montes
Foro Universitario	Spms	Foro Universitario
Foro de Ermua	Spms	Foro de Ermua
Forteza	Sp00	Forteza
Forteza Vila	Sp00	Forteza Vila
Forza Aérea	Spfs	Forza Aérea
Forzas Aéreas de Israel	Spfp	Forzas Aéreas de Israel
Forzas Armadas	Spfp	Forzas Armadas
Forzas de Seguridade do Estado	Spfp	Forzas de Seguridade do Estado
Fox	Spfs	Fox
Foz	Sp00	Foz
Foz de Morcín	Sp00	Foz de Morcín
Fr. Buenaventura Tellado	Sp00	Fr. Buenaventura Tellado
Fraga	Sp00	Fraga
Fran	Spm0	Fran
Fran Aller	Spm0	Fran Aller
Fran Alonso	Spm0	Fran Alonso
Fran Cortegoso	Spm0	Fran Cortegoso
Fran Herbello	Spm0	Fran Herbello
Fran Lago	Spm0	Fran Lago
Fran Llorente	Spm0	Fran Llorente
Fran Pérez	Spm0	Fran Pérez
Fran Ramil	Spm0	Fran Ramil
Fran Rivadulla	Spm0	Fran Rivadulla
Fran Serrejón	Spm0	Fran Serrejón
Fran Sol	Spm0	Fran Sol
Fran Vázquez	Spm0	Fran Vázquez
Fran Zabaleta	Spm0	Fran Zabaleta
France Presse	Spm0	France Presse
Francesco	Spm0	Francesco
Francia	Sp00	Francia
Francis	Spf0	Francis
Francis	Spm0	Francis
Francisca	Spf0	Francisca
Francisca Sauquillo	Spf0	Francisca Sauquillo
Francisco	Spm0	Francisco
Francisco Álvarez Cascos	Spm0	Francisco Álvarez Cascos
Francisco Cal	Spm0	Francisco Cal
Francisco Cal Pardo	Spm0	Francisco Cal Pardo
Francisco Castro	Spm0	Francisco Castro
Francisco Cerviño	Spm0	Francisco Cerviño
Francisco Coloane	Spm0	Francisco Coloane
Francisco Fernández de el Riego	Spm0	Francisco Fernández de el Riego
Francisco García	Spm0	Francisco García
Francisco García-Bobadilla	Spm0	Francisco García-Bobadilla
Francisco Sineiro	Spm0	Francisco Sineiro
Francisco Vázquez	Spm0	Francisco Vázquez
Franco	Sp00	Franco
François	Spm0	François
François Boisrond	Spm0	François Boisrond
François Grin	Spm0	François Grin
François Hollande	Spm0	François Hollande
François Redout	Spm0	François Redout
François Riccoboni	Spm0	François Riccoboni
François Truffaut	Spm0	François Truffaut
François Vieta	Spm0	François Vieta
Frank	Spm0	Frank
Frank Biocca	Spm0	Frank Biocca
Frank Borman	Spm0	Frank Borman
Frank H. Goodyear III	Spm0	Frank H. Goodyear III
Frank Keating	Spm0	Frank Keating
Frank Miller	Spm0	Frank Miller
Frank Muller Hauidsken	Spm0	Frank Muller Hauidsken
Frank Passi	Spm0	Frank Passi
Frank Soutelo	Spm0	Frank Soutelo
Frank Zappa	Spm0	Frank Zappa
Frank de la jungla	Spm0	Frank de la jungla
Frankfurt	Sp00	Frankfurt
Fred Astaire	Spm0	Fred Astaire
Fred Eckhard	Spm0	Fred Eckhard
Fred Martins	Spm0	Fred Martins
Fred Perry	Spm0	Fred Perry
Fred Vargas	Spm0	Fred Vargas
Freitag	Sp00	Freitag
Freixanes	Sp00	Freixanes
Freytag	Sp00	Freytag
Friends	Sp00	Friends
Frisia	Sp00	Frisia
Froilán	Spm0	Froilán
Froiz	Sp00	Froiz
Fronte Popular Galega	Spfs	Fronte Popular Galega
Fuel Vía	Spms	Fuel Vía
Fuenlabrada	Sp00	Fuenlabrada
Fuentes Bardají	Sp00	Fuentes Bardají
Fuentes Quintana	Sp00	Fuentes Quintana
Fuertes	Sp00	Fuertes
Fulxencio	Spm0	Fulxencio
Función Pública	Spfs	Función Pública
Fundación Caixa Galicia	Spfs	Fundación Caixa Galicia
Fundación Dr. Vidal Ríos	Spfs	Fundación Dr. Vidal Ríos
Fundación Esperanza	Spfs	Fundación Esperanza
Fundación Luis Tilve	Spfs	Fundación Luis Tilve
Fundación Pública Escola Galega de Administración Sanitaria	Spfs	Fundación Pública Escola Galega de Administración Sanitaria
Fundación Regino Giráldez Boo e María de el Carmen Groba Varela	Spfs	Fundación Regino Giráldez Boo e María de el Carmen Groba Varela
Fundación Xoán Piñeiro	Spfs	Fundación Xoán Piñeiro
Fuquiño	Spm0	Fuquiño
Fuster	Sp00	Fuster
Fuxan os Ventos	Sp00	Fuxan os Ventos
G-8	Spms	G-8
G. Cabrera Infante	Sp00	G. Cabrera Infante
G. Tosar	Sp00	G. Tosar
G.K. Chesterson	Sp00	G.K. Chesterson
GBU-28	Sp00	GBU-28
Gabinete Técnico de Apoio a o Téxtil	Spms	Gabinete Técnico de Apoio a o Téxtil
Gabinete Técnico de Apoio a o téxtil	Spms	Gabinete Técnico de Apoio a o téxtil
Gabinete de Prensa de a Consellería de Sanidade	Spms	Gabinete de Prensa de a Consellería de Sanidade
Gabinete de a Presidencia	Spms	Gabinete de a Presidencia
Gabriel	Spm0	Gabriel
Gadisa	Sp00	Gadisa
Galaad	Spm0	Galaad
Galaxias	Spfp	Galaxias
Galería Trinta	Spfs	Galería Trinta
Gales	Sp00	Gales
Galicia	Sp00	Galicia
Galicia e a residencia teatral	Sp00	Galicia e a residencia teatral
Galicia-Norte de Portugal	Sp00	Galicia-Norte de Portugal
Galicia... flash	Sp00	Galicia... flash
Galindo	Sp00	Galindo
Galisindo	Spm0	Galisindo
Galiza	Sp00	Galiza
Gallardón	Sp00	Gallardón
Gallego Fernández	Sp00	Gallego Fernández
Gandhi	Sp00	Gandhi
Garantía Social	Spfs	Garantía Social
García	Sp00	García
García Alix	Sp00	García Alix
García Leira	Sp00	García Leira
García Lorca	Sp00	García Lorca
García Sánchez	Sp00	García Sánchez
García-Bobadilla	Sp00	García-Bobadilla
Garda Civil	Spfs	Garda Civil
Gaspar	Spm0	Gaspar
Gaza	Sp00	Gaza
Genaro Borrás	Spm0	Genaro Borrás
Genaro Martínez	Spm0	Genaro Martínez
Genaro Martínez Sánchez	Spm0	Genaro Martínez Sánchez
Generalitat	Spfs	Generalitat
Generalitat Valenciana	Sp00	Generalitat Valenciana
Generalitat de Cataluña	Spfs	Generalitat de Cataluña
Génova	Sp00	Génova
George Lucas	Spm0	George Lucas
Gerardo	Spm0	Gerardo
Gerardo Fernández Albor	Spm0	Gerardo Fernández Albor
Gerardo Galeote	Spm0	Gerardo Galeote
Gerardo Gayoso	Spm0	Gerardo Gayoso
Gerês-Xurés	Sp00	Gerês-Xurés
Gerhard Schroder	Spm0	Gerhard Schroder
Gerhard Schroeder	Spm0	Gerhard Schroeder
Gerhard Schroeder	Spms	Gerhard Schroeder
Germán	Spm0	Germán
Germán Ancochea	Spm0	Germán Ancochea
Germán Antúnez	Spm0	Germán Antúnez
Germán Bou	Spm0	Germán Bou
Germán Carou	Spm0	Germán Carou
Germán Corral	Spm0	Germán Corral
Germán Fernández	Spm0	Germán Fernández
Germán Fornos	Spm0	Germán Fornos
Germán Gómez Varela	Spm0	Germán Gómez Varela
Germán González	Spm0	Germán González
Germán Kortabarria	Spm0	Germán Kortabarria
Germán Porras	Spm0	Germán Porras
Germán Porrás	Spm0	Germán Porrás
Germán Rodríguez	Spm0	Germán Rodríguez
Gerry Adams	Spm0	Gerry Adams
Gestha de Xestión de Facenda	Sp00	Gestha de Xestión de Facenda
Ghibli	Sp00	Ghibli
Gibson	Sp00	Gibson
Gil	Spm0	Gil
Gilbert Keith Chesterton	Spm0	Gilbert Keith Chesterton
Ginobili	Sp00	Ginobili
Gipuzko Buru Batzar	Spms	Gipuzko Buru Batzar
Giuliani	Sp00	Giuliani
Glasgow	Sp00	Glasgow
Glenda Jackson	Spf0	Glenda Jackson
Glenn Gould	Spm0	Glenn Gould
Glenn Miller	Spm0	Glenn Miller
Gloria	Spf0	Gloria
Gobelas	Sp00	Gobelas
Goberno	Sp00	Goberno
Goberno	Spms	Goberno
Goberno de Pequín	Spms	Goberno de Pequín
Goethe	Sp00	Goethe
Goián	Sp00	Goián
Gol	Sp00	Gol
Golani	Sp00	Golani
Gómez	Sp00	Gómez
Gómez Santamarina	Sp00	Gómez Santamarina
Gondomar	Sp00	Gondomar
González	Sp00	González
González Manchón	Sp00	González Manchón
González Sobral	Sp00	González Sobral
Gonzalo	Spm0	Gonzalo
Gonzalo Rodríguez	Spm0	Gonzalo Rodríguez
Gonzalo Rodríguez Álvarez	Spm0	Gonzalo Rodríguez Álvarez
Gonzalo Rodríguez Tenreiro	Spm0	Gonzalo Rodríguez Tenreiro
Gonzalo Uriarte	Spm0	Gonzalo Uriarte
Google	Sp00	Google
Goran Aleksic	Spm0	Goran Aleksic
Gordon Brown	Spm0	Gordon Brown
Gore	Sp00	Gore
Goretti Sanmartín	Spf0	Goretti Sanmartín
Goretti Sanmartín Rei	Spf0	Goretti Sanmartín Rei
Goytisolo	Sp00	Goytisolo
Grace	Sp00	Grace
Grace Kelly	Spf0	Grace Kelly
Gran	Sp00	Gran Bretaña
Gran Bretaña	Sp00	Gran Bretaña
Gran Canaria	Sp00	Gran Canaria
Gran Guerra	Spfs	Gran Guerra
Granada	Sp00	Granada
Grandal	Sp00	Grandal
Grdulica	Sp00	Grdulica
Grecia	Sp00	Grecia
Greco	Spm0	Greco
Gregorio	Spm0	Gregorio
Grimaldi	Sp00	Grimaldi
Griñán	Sp00	Griñán
Grixoa	Sp00	Grixoa
Grupo	Spms	Grupo
Grupo Cable Galego	Spms	Grupo Cable Galego
Grupo Correo Gallego	Spms	Grupo Correo Gallego
Grupo Mixto	Spms	Grupo Mixto
Grupo Parlamentario Mixto	Spms	Grupo Parlamentario Mixto
Grupo Popular	Spms	Grupo Popular
Grupo Socialista	Spms	Grupo Socialista
Grupo Torras	Spms	Grupo Torras
Grupo dos Sete	Spms	Grupo dos Sete
Grupo-17	Spms	Grupo-17
Guadagni	Sp00	Guadagni
Guadalaxara	Sp00	Guadalaxara
Guadalupe	Spf0	Guadalupe
Guennadi Ziugánov	Spm0	Guennadi Ziugánov
Guerra do Golfo	Spfs	Guerra do Golfo
Guillén	Spm0	Guillén
Guillerme	Spm0	Guillerme
Guillerme Vázquez	Spm0	Guillerme Vázquez
Guillermina Domínguez	Spf0	Guillermina Domínguez
Guillermo	Spm0	Guillermo
Guillermo Fernández-Obanza	Spm0	Guillermo Fernández-Obanza
Guillermo Mesonero	Spm0	Guillermo Mesonero
Guillermo Mesonero Romano	Spm0	Guillermo Mesonero Romano
Guinea	Sp00	Guinea
Guipúscoa	Sp00	Guipúscoa
Guísamo	Sp00	Guísamo
Guitiriz	Sp00	Guitiriz
Guivati	Sp00	Guivati
Gumersinda	Spf0	Gumersinda
Gumersindo	Spm0	Gumersindo
Guntiñas	Sp00	Guntiñas
Gustavo	Spm0	Gustavo
Gustavo Losada	Spm0	Gustavo Losada
Gutiérrez	Sp00	Gutiérrez
Gutiérrez Aragón	Sp00	Gutiérrez Aragón
Gutiérrez Lara	Sp00	Gutiérrez Lara
Gutiérrez López, Xosé	Spm0	Gutiérrez López, Xosé
Gutiérrez Lumbreras	Sp00	Gutiérrez Lumbreras
Gutiérrez Menoyo	Sp00	Gutiérrez Menoyo
Gutiérrez Solana	Sp00	Gutiérrez Solana
Gutiérrez de Vera	Sp00	Gutiérrez de Vera
Guy	Spm0	Guy
Guy Debord	Spm0	Guy Debord
Guy Delisle	Spm0	Guy Delisle
Guy Pearce	Spm0	Guy Pearce
Guzmán	Sp00	Guzmán
Habana	Sp00	Habana
Haia	Spfs	Haia
Hall	Sp00	Hall
Hamallaj	Sp00	Hamallaj
Hamás	Sp00	Hamás
Hamilton	Sp00	Hamilton
Hamilton Leithauser	Sp00	Hamilton Leithauser
Handke	Sp00	Handke
Hans Eichel	Spm0	Hans Eichel
Hanzhou	Sp00	Hanzhou
Harold	Spm0	Harold
Harrier	Spms	Harrier
Harrier AV-8B	Spms	Harrier AV-8B
Hashim Taci	Spm0	Hashim Taci
Hassan II	Spm0	Hassan II
Hawai	Sp00	Hawai
Hawking	Sp00	Hawking
Héctor Moreneli	Spm0	Héctor Moreneli
Helena	Spf0	Helena
Hélène	Spfs	Hélène
Hellen KermisIngrid	Spf0	Hellen KermisIngrid
Helms Burton	Sp00	Helms Burton
Helsinki	Sp00	Helsinki
Henrique	Spm0	Henrique
Hepburn	Sp00	Hepburn
Hércules	Spm0	Hércules
Hermenexilda	Spf0	Hermenexilda
Hermexildo	Spm0	Hermexildo
Herminia	Spf0	Herminia
Herminio	Spm0	Herminio
Hernández Cochón	Sp00	Hernández Cochón
Hernando	Sp00	Hernando
Herrero	Sp00	Herrero
Herrero de Miñón	Sp00	Herrero de Miñón
Herri Batasuna	Sp00	Herri Batasuna
Hierro	Sp00	Hierro
Hilario	Spm0	Hilario
Hilario Álvarez	Spm0	Hilario Álvarez
Hilario Cabana	Spm0	Hilario Cabana
Hilario Lanza	Spm0	Hilario Lanza
Hilario Pino	Spm0	Hilario Pino
Hilary	Spf0	Hilary
Hilary Clinton	Spf0	Hilary Clinton
Hilary Swank	Spf0	Hilary Swank
Hillary Clinton	Spf0	Hillary Clinton
Hipólito G. Navarro	Spm0	Hipólito G. Navarro
Hipólito López	Spm0	Hipólito López
Hipólito López Gómez	Spm0	Hipólito López Gómez
Hispania	Sp00	Hispania
Hispanoamérica	Sp00	Hispanoamérica
Historia 16	Sp00	Historia 16
Historia Moderna	Sp00	Historia Moderna
Hizbulá	Sp00	Hizbulá
Hizbulá	Spms	Hizbulá
Holanda	Sp00	Holanda
Holger Cáceres	Spm0	Holger Cáceres
Hollywood	Sp00	Hollywood
Hong Kong	Sp00	Hong Kong
Honorina	Spf0	Honorina
Honoris Causa	Sp00	Honoris Causa
Hoover	Sp00	Hoover
Horacio	Spm0	Horacio
Horacio Gómez	Spm0	Horacio Gómez
Hortensia	Spf0	Hortensia
Hospital Materno Infantil Teresa Herrera	Spms	Hospital Materno Infantil Teresa Herrera
Hospital Meixoeiro	Spms	Hospital Meixoeiro
Hospital Montecelo	Spms	Hospital Montecelo
Hospital Universitario de Copenhaguen	Spms	Hospital Universitario de Copenhaguen
Hospital Virgen de la Arrixaca	Spms	Hospital Virgen de la Arrixaca
Hospital de Conxo	Spms	Hospital de Conxo
Hospital do Meixoeiro	Spms	Hospital do Meixoeiro
Hotel Almirante	Spms	Hotel Almirante
Hotel Marmatino	Spms	Hotel Marmatino
Huelva	Sp00	Huelva
Huesca	Sp00	Huesca
Huguet	Sp00	Huguet
Humanidades	Sp00	Humanidades
Humberto Fernández	Spm0	Humberto Fernández
Humberto Hernández Reinoso	Spm0	Humberto Hernández Reinoso
Hungría	Sp00	Hungría
Hurtado	Sp00	Hurtado
I Congreso Nacional de a Sociedade Española de Cirurxía Bucal	Spms	I Congreso Nacional de a Sociedade Española de Cirurxía Bucal
I congreso nacional de cirurxía bucal	Spms	I congreso nacional de cirurxía bucal
IAC-80	Sp00	IAC-80
II Certame Galego de Música Pop-Rock Xuventude 99	Spms	II Certame Galego de Música Pop-Rock Xuventude 99
II Confederación Nacional de Xemelgos	Spfs	II Confederación Nacional de Xemelgos
II Guerra Mundial	Spfs	II Guerra Mundial
Iago	Spm0	Iago
Ibáñez	Sp00	Ibáñez
Ibarra	Sp00	Ibarra
Ibarretxe	Sp00	Ibarretxe
Iberia	Sp00	Iberia
Iberia 6402 Madrid-México	Sp00	Iberia 6402 Madrid-México
Iberoamérica	Sp00	Iberoamérica
Ibiza	Sp00	Ibiza
Ibrahim Rugova	Spm0	Ibrahim Rugova
Iceta	Sp00	Iceta
Icía	Spf0	Icía
Ifixenia	Spf0	Ifixenia
Iglesias	Sp00	Iglesias
Iglesias Chouzas	Sp00	Iglesias Chouzas
Iglesias Corral	Sp00	Iglesias Corral
Iglesias, Antonio	Spm0	Iglesias, Antonio
Ignacia	Spf0	Ignacia
Ignacio	Spm0	Ignacio
Igor Ivanov	Spm0	Igor Ivanov
Igor Karachentsev	Spm0	Igor Karachentsev
Igrexa	Spfs	Igrexa
Ilduara	Spf0	Ilduara
Illa Couto	Sp00	Illa Couto
Illa de a Toxa	Spfs	Illa de a Toxa
Illas Canarias	Sp00	Illas Canarias
Iñaki	Spm0	Iñaki
Iñaki Anasagasti	Spm0	Iñaki Anasagasti
Iñaki Beaumont	Spm0	Iñaki Beaumont
Iñaki Fariña Muradás	Spm0	Iñaki Fariña Muradás
Iñaki Gabilondo	Spm0	Iñaki Gabilondo
Iñaki López	Spm0	Iñaki López
Iñaki Rivera Beiras	Spm0	Iñaki Rivera Beiras
Iñaki Sánchez	Spm0	Iñaki Sánchez
Iñaki Sanz	Spm0	Iñaki Sanz
Iñaki Urdangarín	Spm0	Iñaki Urdangarín
Iñaki de Juana Chaos	Spm0	Iñaki de Juana Chaos
Indar	Sp00	Indar
India	Sp00	India
Índice Manpower	Sp00	Índice Manpower
Industria	Sp00	Industria
Industria , Comercio e Minería	Sp00	Industria , Comercio e Minería
Industria e Comercio	Sp00	Industria e Comercio
Inés	Spf0	Inés
Inespal	Sp00	Inespal
Informativos Telecinco	Sp00	Informativos Telecinco
Inglaterra	Sp00	Inglaterra
Inglés en a rede	Sp00	Inglés en a rede
Ingrid Bergman	Spf0	Ingrid Bergman
Ingrid Betancourt	Spf0	Ingrid Betancourt
Ingrid Lupatsch	Spf0	Ingrid Lupatsch
Iniciativa Comunitaria ADAPT-Bis	Spfs	Iniciativa Comunitaria ADAPT-Bis
Iniciativa per Catalunya-Verds	Sp00	Iniciativa per Catalunya-Verds
Inmaculada	Spf0	Inmaculada
Inocencia	Spf0	Inocencia
Inocencio	Spm0	Inocencio
Instituto Galego de Artes Escénicas e Musicais	Spms	Instituto Galego de Artes Escénicas e Musicais
Instituto Galego de Estatística	Spms	Instituto Galego de Estatística
Instituto Nacional de Estatística	Spms	Instituto Nacional de Estatística
Instituto Stella Maris	Spms	Instituto Stella Maris
Instituto Tecnológico Geominero de España	Spms	Instituto Tecnológico Geominero de España
Instituto de Astrofísica	Spms	Instituto de Astrofísica
Instituto de Investigacións Políticas	Spms	Instituto de Investigacións Políticas
Intercampus	Sp00	Intercampus
Interior	Spms	Interior
International Business Machines	Spfs	International Business Machines
Internet	Sp00	Internet
Internet Explorer	Spms	Internet Explorer
Interreg III	Sp00	Interreg III
Investigación e Técnicas de Mercado	Sp00	Investigación e Técnicas de Mercado
Irán	Sp00	Irán
Iraq	Sp00	Iraq
Iria	Spf0	Iria
Irimia	Spf0	Irimia
Irlanda	Sp00	Irlanda
Irlanda do Norte	Sp00	Irlanda do Norte
Irmandade de Centros Galegos en Euscadi	Spfs	Irmandade de Centros Galegos en Euscadi
Irún	Sp00	Irún
Isa	Spf0	Isa
Isaac	Spm0	Isaac
Isabel	Spf0	Isabel
Isabel II	Spf0	Isabel II
Isabel II de Inglaterra	Spf0	Isabel II de Inglaterra
Isabel Salazar	Spf0	Isabel Salazar
Isabel Tocino	Spf0	Isabel Tocino
Isaías	Spm0	Isaías
Isaías Zaragoza	Spm0	Isaías Zaragoza
Isidro	Spm0	Isidro
Islandia	Sp00	Islandia
Isolina	Spf0	Isolina
Israel	Sp00	Israel
Istambul	Sp00	Istambul
Italia	Sp00	Italia
Iugoslavia	Sp00	Iugoslavia
Iván	Spm0	Iván
Iván Marcos	Spm0	Iván Marcos
Ivanov	Sp00	Ivanov
Izquierda Andaluza	Sp00	Izquierda Andaluza
Izquierda Unida	Sp00	Izquierda Unida
J. Carrol	Sp00	J. Carrol
J. Craig Venter	Sp00	J. Craig Venter
J. Craig Venter	Spm0	J. Craig Venter
J. Pérez Oya	Sp00	J. Pérez Oya
J.J. Abrams	Sp00	J.J. Abrams
J.R. Pérez Ornia	Sp00	J.R. Pérez Ornia
Jacinto	Spm0	Jacinto
Jacinto Bátiz	Spm0	Jacinto Bátiz
Jacinto Casal	Spm0	Jacinto Casal
Jacinto Parga	Spm0	Jacinto Parga
Jacinto Rey	Spm0	Jacinto Rey
Jacinto Verdaguer	Spm0	Jacinto Verdaguer
Jacinto Zunzunegui Romo	Spm0	Jacinto Zunzunegui Romo
Jack	Spm0	Jack
Jack Straw	Spm0	Jack Straw
Jackson	Sp00	Jackson
Jácome	Sp00	Jácome
Jacques Antoine Canavaggio	Spm0	Jacques Antoine Canavaggio
Jaén	Sp00	Jaén
Jaime García	Spm0	Jaime García
Jaime López Cosío	Spm0	Jaime López Cosío
Jaime Mayor Oreja	Spm0	Jaime Mayor Oreja
James	Spm0	James
James Baker	Spm0	James Baker
James Blake	Spm0	James Blake
James Bond	Spm0	James Bond
James Cameron	Spm0	James Cameron
James Fox	Spm0	James Fox
James Franco	Spm0	James Franco
James Hansen	Spm0	James Hansen
James Joyce	Spm0	James Joyce
James L. Smithson	Spm0	James L. Smithson
James Lovell	Spm0	James Lovell
James Merrill	Spm0	James Merrill
James Middleton	Spm0	James Middleton
James Nash	Spm0	James Nash
James O'Neal	Spm0	James O'Neal
James O'neal	Spm0	James O'neal
James Rhodes	Spm0	James Rhodes
James Scott	Spm0	James Scott
James Taylor Quartet	Spm0	James Taylor Quartet
James Van Der Beek	Spm0	James Van Der Beek
James Watson	Spm0	James Watson
James Welling	Spm0	James Welling
Jamie Shea	Spm0	Jamie Shea
Janice López	Spf0	Janice López
Jarcujak	Sp00	Jarcujak
Javier	Spm0	Javier
Javier Arenas	Spm0	Javier Arenas
Javier Balza	Spm0	Javier Balza
Javier Barreiro	Spm0	Javier Barreiro
Javier Moral Medina	Spm0	Javier Moral Medina
Javier Otero	Spm0	Javier Otero
Javier Pomés	Spm0	Javier Pomés
Javier Solana	Spm0	Javier Solana
Javier Tallada	Spm0	Javier Tallada
Javier de la Cerda	Spm0	Javier de la Cerda
Javier de la Rosa	Spm0	Javier de la Rosa
Javieriño	Spm0	Javieriño
Jean Baudrillard	Spm0	Jean Baudrillard
Jean Charest	Spm0	Jean Charest
Jean Chrtien	Spm0	Jean Chrtien
Jean Cocteau	Spm0	Jean Cocteau
Jean Deneuve	Spm0	Jean Deneuve
Jean Díaz	Spm0	Jean Díaz
Jean Dieuzaide	Spm0	Jean Dieuzaide
Jean Louis Campora	Spm0	Jean Louis Campora
Jean Luc Dehaene	Spm0	Jean Luc Dehaene
Jean Luc Godard	Spm0	Jean Luc Godard
Jean Marie Luton	Spm0	Jean Marie Luton
Jean Marie Okutu	Spm0	Jean Marie Okutu
Jean Nouvelle	Spm0	Jean Nouvelle
Jean Paul Sartre	Spm0	Jean Paul Sartre
Jean Piaget	Spm0	Jean Piaget
Jean Pierre Sinapi	Spm0	Jean Pierre Sinapi
Jean Pronc	Spm0	Jean Pronc
Jean Renoir	Spm0	Jean Renoir
Jean Rey	Spm0	Jean Rey
Jean Rostand	Spm0	Jean Rostand
Jean Siméon Chardin	Spm0	Jean Siméon Chardin
Jean Todt	Spm0	Jean Todt
Jean Vigo	Spm0	Jean Vigo
Jecinza	Sp00	Jecinza
Jefferson	Sp00	Jefferson
Jenkins	Sp00	Jenkins
Jerónimo Forteza	Spm0	Jerónimo Forteza
Jesse Jackson	Spm0	Jesse Jackson
Jessie Jackson	Spm0	Jessie Jackson
Jesús	Spm0	Jesús
Jesús Asorey	Spm0	Jesús Asorey
Jesús Asorey Carril	Spm0	Jesús Asorey Carril
Jesús Bal y Gay	Spfs	Jesús Bal y Gay
Jesus Christ Superstar	Spm0	Jesus Christ Superstar
Jesús Joaquín Brea	Spm0	Jesús Joaquín Brea
Jesus Manuel da Torre Martins	Spm0	Jesus Manuel da Torre Martins
Jesús Mosquera	Spm0	Jesús Mosquera
Jesús Posada	Spm0	Jesús Posada
Jesús Posadas	Spm0	Jesús Posadas
Jesús Ramón Copa	Spm0	Jesús Ramón Copa
Jesús Saavedra	Spm0	Jesús Saavedra
Jevrosima	Spm0	Jevrosima
Jim	Spm0	Jim
Jimena	Spfs	Jimena
Jimena e Felisa Fernández de la Vega	Spfs	Jimena e Felisa Fernández de la Vega
Jimena y Elisa Fernández de la Vega	Spfs	Jimena y Elisa Fernández de la Vega
Jiménez	Sp00	Jiménez
Jiménez Aguilar	Sp00	Jiménez Aguilar
Jiménez Ambel	Sp00	Jiménez Ambel
Jiménez Casas	Sp00	Jiménez Casas
Jiménez Delgado	Sp00	Jiménez Delgado
Jiménez Losantos	Sp00	Jiménez Losantos
Jiménez Morales	Sp00	Jiménez Morales
Jiménez Pérez	Sp00	Jiménez Pérez
Jiménez Ugarte	Sp00	Jiménez Ugarte
Jiménez de Parga	Sp00	Jiménez de Parga
Joan	Spm0	Joan
Joan Lerma	Spm0	Joan Lerma
Joan Reventós	Spm0	Joan Reventós
Joao Cravinho	Spm0	Joao Cravinho
Joaquín	Spm0	Joaquín
Joaquin Almunia	Spm0	Joaquin Almunia
Joaquín Almunia	Spm0	Joaquín Almunia
Joaquín Brea	Spm0	Joaquín Brea
Joaquin Phoenix	Spm0	Joaquin Phoenix
Joe	Spm0	Joe
Joel Rickett	Spm0	Joel Rickett
Joel Slemrod	Spm0	Joel Slemrod
Johan	Spm0	Johan
Johanna Sigurdardottir	Spf0	Johanna Sigurdardottir
Johansson	Sp00	Johansson
John	Spm0	John
John Elliot	Spm0	John Elliot
John Taylor	Spm0	John Taylor
Jonas Folger	Spm0	Jonas Folger
Jorcano	Sp00	Jorcano
Jordi Pujol	Spm0	Jordi Pujol
Jorge	Spm0	Jorge
Jorge Acuña	Spm0	Jorge Acuña
Jorge Alonso	Spm0	Jorge Alonso
Jorge Álvarez Yagüez	Spm0	Jorge Álvarez Yagüez
Jorge Barbi	Spm0	Jorge Barbi
Jorge Barbo	Spm0	Jorge Barbo
Jorge Barros	Spm0	Jorge Barros
Jorge Borrow	Spm0	Jorge Borrow
Jorge Castillo	Spm0	Jorge Castillo
Jorge Cebreiros	Spm0	Jorge Cebreiros
Jorge Coelho	Spm0	Jorge Coelho
Jorge Coira	Spm0	Jorge Coira
Jorge Drexler	Spm0	Jorge Drexler
Jorge F. Torres	Spm0	Jorge F. Torres
Jorge Fernández	Spm0	Jorge Fernández
Jorge Flores Fernández	Spm0	Jorge Flores Fernández
Jorge Franco	Spm0	Jorge Franco
Jorge Francos Liñares	Spm0	Jorge Francos Liñares
Jorge Garbajosa	Spm0	Jorge Garbajosa
Jorge González	Spm0	Jorge González
Jorge Hernández Urcera	Spm0	Jorge Hernández Urcera
Jorge Herralde	Spm0	Jorge Herralde
Jorge J. Candán	Spm0	Jorge J. Candán
Jorge J. Rodríguez Núñez	Spm0	Jorge J. Rodríguez Núñez
Jorge Javier Vázquez	Spm0	Jorge Javier Vázquez
Jorge López	Spm0	Jorge López
Jorge Lorenzo	Spm0	Jorge Lorenzo
Jorge Luis Borges	Spm0	Jorge Luis Borges
Jorge Mario Bergoglio	Spm0	Jorge Mario Bergoglio
Jorge Mario Pedro Vargas Llosa	Spm0	Jorge Mario Pedro Vargas Llosa
Jorge Martín	Spm0	Jorge Martín
Jorge Martínez Aspar	Spm0	Jorge Martínez Aspar
Jorge Medina	Spm0	Jorge Medina
Jorge Mira	Spm0	Jorge Mira
Jorge Ortiz de Landázuri	Spm0	Jorge Ortiz de Landázuri
Jorge Oteiza	Spm0	Jorge Oteiza
Jorge Parada	Spm0	Jorge Parada
Jorge Pascual Llorens	Spm0	Jorge Pascual Llorens
Jorge Perugorría	Spm0	Jorge Perugorría
Jorge Prieto	Spm0	Jorge Prieto
Jorge Puente Prieto	Spm0	Jorge Puente Prieto
Jorge Pumar	Spm0	Jorge Pumar
Jorge Reverte	Spm0	Jorge Reverte
Jorge Rey	Spm0	Jorge Rey
Jorge Ribó Landín	Spm0	Jorge Ribó Landín
Jorge Rodríguez	Spm0	Jorge Rodríguez
Jorge Romeu	Spm0	Jorge Romeu
Jorge Sampaio	Spm0	Jorge Sampaio
Jorge Sampedro Santos	Spm0	Jorge Sampedro Santos
Jorge Sanz	Spm0	Jorge Sanz
Jorge Suanzes	Spm0	Jorge Suanzes
Jorge Suárez	Spm0	Jorge Suárez
Jorge Trías	Spm0	Jorge Trías
Jorge Vázquez	Spm0	Jorge Vázquez
Jorge Viroga	Spm0	Jorge Viroga
Jorge Volpi	Spm0	Jorge Volpi
Jorge Wagensberg	Spm0	Jorge Wagensberg
Joschka Fischer	Spm0	Joschka Fischer
Jose	Spm0	Jose
José	Spm0	José
Jose Afonso	Spm0	Jose Afonso
José Alberto Piñeiro	Spm0	José Alberto Piñeiro
José Antonio Ardanza	Spm0	José Antonio Ardanza
José Antonio Farto	Spm0	José Antonio Farto
José Antonio Flórez Lozano	Spm0	José Antonio Flórez Lozano
José Antonio Ibars	Spm0	José Antonio Ibars
José Antonio Labordeta	Spm0	José Antonio Labordeta
Jose Antonio Muñoz Rojas	Spm0	Jose Antonio Muñoz Rojas
José Antonio Pino	Spm0	José Antonio Pino
José Antonio Quiroga y Piñeyro	Spm0	José Antonio Quiroga y Piñeyro
José Barea	Spm0	José Barea
José Barea Tejeiro	Spm0	José Barea Tejeiro
José Benito López Costa	Spm0	José Benito López Costa
José Benito Vázquez Chaves	Spm0	José Benito Vázquez Chaves
José Blanco	Spm0	José Blanco
José Bono	Spm0	José Bono
Jose Borrell	Spm0	Jose Borrell
José Borrell	Spm0	José Borrell
José Carracao Gutiérrez	Spm0	José Carracao Gutiérrez
José Cora	Spm0	José Cora
Jose Corderí	Spm0	Jose Corderí
José Couceiro	Spm0	José Couceiro
José Cuíña	Spm0	José Cuíña
José Enrique Elvira	Spm0	José Enrique Elvira
José Enrique Serrano	Spm0	José Enrique Serrano
Jose Ernesto Díaz Noriega	Spm0	Jose Ernesto Díaz Noriega
Jose Ernesto Díaz-Noriega	Spm0	Jose Ernesto Díaz-Noriega
José Folchi	Spm0	José Folchi
José Hierro	Spm0	José Hierro
Jose Ignacio	Spm0	Jose Ignacio
Jose Luis	Spm0	Jose Luis
José Luís Álvarez	Spm0	José Luís Álvarez
José Luis Arribas Llorente	Spm0	José Luis Arribas Llorente
Jose Luis Basante Lago	Spm0	Jose Luis Basante Lago
José Luis Gómez	Spm0	José Luis Gómez
Jose Luis González	Spm0	Jose Luis González
José Luis Jorcano	Spm0	José Luis Jorcano
José Luis Méndez	Spm0	José Luis Méndez
José Luis Méndez López	Spm0	José Luis Méndez López
José Luis Morlanes	Spm0	José Luis Morlanes
Jose Luís Puentes	Spm0	Jose Luís Puentes
Jose Luis Rodríguez Zapatero	Spm0	Jose Luis Rodríguez Zapatero
José Luis Rodríguez Zapatero	Spm0	José Luis Rodríguez Zapatero
Jose Luís Sánchez Verasalgado	Spm0	Jose Luís Sánchez Verasalgado
José Luis Taboada	Sp00	José Luis Taboada
Jose Luis Terrón	Spm0	Jose Luis Terrón
José Manuel Amoedo	Spm0	José Manuel Amoedo
José Manuel Barreiro	Spm0	José Manuel Barreiro
Jose Manuel Estévez	Spm0	Jose Manuel Estévez
José Manuel Fernández Norniella	Spm0	José Manuel Fernández Norniella
José Manuel González	Spm0	José Manuel González
José Manuel Pazos Torres	Spm0	José Manuel Pazos Torres
José Manuel Rey	Spm0	José Manuel Rey
José Manuel Rodríguez Lamas	Spm0	José Manuel Rodríguez Lamas
José Manuel Romay Beccaría	Spm0	José Manuel Romay Beccaría
José Manuel Yanes	Spm0	José Manuel Yanes
José Manuel Yebra-Pimentel	Spm0	José Manuel Yebra-Pimentel
Jose Mari Aznar	Spm0	Jose Mari Aznar
José María Aznar	Spfs	José María Aznar
José María Aznar	Spm0	José María Aznar
Jose María Castroviejo	Spm0	Jose María Castroviejo
José María Chapela Seijo	Spm0	José María Chapela Seijo
José María Cuevas	Spm0	José María Cuevas
José María García Leira	Spm0	José María García Leira
José María Gil Robles	Spm0	José María Gil Robles
José María Hernández Cochón	Spm0	José María Hernández Cochón
José María Huguet	Spm0	José María Huguet
José María Michavila	Spm0	José María Michavila
José María Robles Fraga	Spm0	José María Robles Fraga
José María Suárez Quintanilla	Spm0	José María Suárez Quintanilla
Jose Mourinho	Spm0	Jose Mourinho
Jose Oliveira	Spm0	Jose Oliveira
José Pazos	Spm0	José Pazos
"José Ramón "" Gallego "" Fernández"	Spm0	"José Ramón "" Gallego "" Fernández"
"José Ramón ""Gallego"" Fernández"	Spm0	"José Ramón ""Gallego"" Fernández"
José Ramón Fernández	Spm0	José Ramón Fernández
José Ramón Fernández Alvarez	Spm0	José Ramón Fernández Alvarez
José Ramón Fuertes	Spm0	José Ramón Fuertes
José Ramón Gómez	Spm0	José Ramón Gómez
Jose Varela	Spm0	Jose Varela
José Vilar	Spm0	José Vilar
José Vilar Casal	Spm0	José Vilar Casal
José álvarez de Paz	Spm0	José álvarez de Paz
Josefa	Spf0	Josefa
Josefa Charlín	Spf0	Josefa Charlín
Josefa Charlín Pomares	Spf0	Josefa Charlín Pomares
Josefa Fernández Álvarez	Spf0	Josefa Fernández Álvarez
Josefa Izquierdo	Spf0	Josefa Izquierdo
Josefa Ortega Gaona	Spf0	Josefa Ortega Gaona
Josefa Rodríguez	Spf0	Josefa Rodríguez
Josefa Solá	Spf0	Josefa Solá
Josep	Spm0	Josep
Josep Borrell	Spm0	Josep Borrell
Josep Piqué	Spm0	Josep Piqué
Joseph	Spm0	Joseph
Joseph Losey	Spm0	Joseph Losey
Jove	Sp00	Jove
Joyce	Sp00	Joyce
Jo~ao Cravinho	Spm0	Jo~ao Cravinho
Juan	Spm0	Juan
Juan Antonio Garrido	Spm0	Juan Antonio Garrido
Juan Blanco Rouco	Spm0	Juan Blanco Rouco
Juan Canalejo	Spms	Juan Canalejo
Juan Cardona	Sp00	Juan Cardona
Juan Carlos Rodríguez Ibarra	Spm0	Juan Carlos Rodríguez Ibarra
Juan Carlos Villarino	Spm0	Juan Carlos Villarino
Juan Casares	Spm0	Juan Casares
Juan Casares Long	Spm0	Juan Casares Long
Juan Corral	Spm0	Juan Corral
Juan Costa	Spm0	Juan Costa
Juan Fontela Fernández	Spm0	Juan Fontela Fernández
Juan Fontenla	Spm0	Juan Fontenla
Juan Gras	Spm0	Juan Gras
Juan Gras Llinares	Spm0	Juan Gras Llinares
Juan José Folchi	Spm0	Juan José Folchi
Juan José Ibarretxe	Spm0	Juan José Ibarretxe
Juan José Lucas	Spm0	Juan José Lucas
Juan José Sánchez Arévalo	Spm0	Juan José Sánchez Arévalo
Juan Luis Gallego	Spm0	Juan Luis Gallego
Juan Luis Pedrosa	Spm0	Juan Luis Pedrosa
Juan Manuel Diz Guedes	Spm0	Juan Manuel Diz Guedes
Juan Manuel García-Margallo	Spm0	Juan Manuel García-Margallo
Juan Manuel Páramo Neyra	Spm0	Juan Manuel Páramo Neyra
Juan María Juaristi	Spm0	Juan María Juaristi
Juan Ojeda	Spm0	Juan Ojeda
Juan Pedro Valentín	Spm0	Juan Pedro Valentín
Juan Rosai	Spm0	Juan Rosai
Juan Vieites	Spm0	Juan Vieites
Juanito	Spm0	Juanito
Juaristi	Sp00	Juaristi
Judas Iscariote	Spm0	Judas Iscariote
Judas Priest	Spm0	Judas Priest
Judith Bartolomé	Spf0	Judith Bartolomé
Judith Butler	Spf0	Judith Butler
Judith Kroll	Spf0	Judith Kroll
Judith Mascó	Spf0	Judith Mascó
Judith Niemeier	Spf0	Judith Niemeier
Judy Garland	Spf0	Judy Garland
Julia	Spf0	Julia
Julia Holter	Spf0	Julia Holter
Julia Llopiz	Spf0	Julia Llopiz
Julia Luque Fernández	Spf0	Julia Luque Fernández
Julia Roberts	Spf0	Julia Roberts
Julia Uceda	Spf0	Julia Uceda
Julia Vaquero	Spf0	Julia Vaquero
Julia Vaquero Sousa	Spf0	Julia Vaquero Sousa
Julián	Spm0	Julián
Julio	Spm0	Julio
Julio Aldemira	Spm0	Julio Aldemira
Julio Álvarez	Spm0	Julio Álvarez
Julio Anguita	Spm0	Julio Anguita
Julio Antonio Blázquez García	Spm0	Julio Antonio Blázquez García
Julio Dios Ramallo	Spm0	Julio Dios Ramallo
Julio Fernández	Spm0	Julio Fernández
Julio Fernández Gayoso	Spm0	Julio Fernández Gayoso
Julio álvarez	Spm0	Julio álvarez
Junta Aragonesista	Spfs	Junta Aragonesista
Juste	Sp00	Juste
Justo de Benito	Spm0	Justo de Benito
K. Raikkonen	Sp00	K. Raikkonen
Kamandi	Sp00	Kamandi
Kane	Sp00	Kane
Karen Owen	Spf0	Karen Owen
Karl	Spm0	Karl
Karl Lagerfeld	Spm0	Karl Lagerfeld
Karl Malone	Spm0	Karl Malone
Karl Maria von Weber	Spm0	Karl Maria von Weber
Karl Soares	Spm0	Karl Soares
Karpov	Sp00	Karpov
Kasparov	Sp00	Kasparov
Katty	Spf0	Katty
Kay Kendall	Spf0	Kay Kendall
Kimi Raikkonen	Spm0	Kimi Raikkonen
Kiñas	Sp00	Kiñas
Kiriat Shemoná	Sp00	Kiriat Shemoná
Kohler	Sp00	Kohler
Konrad Freytag	Spm0	Konrad Freytag
Kosava	Sp00	Kosava
Kosovo	Sp00	Kosovo
Kósovo	Sp00	Kósovo
Kotenkov	Sp00	Kotenkov
Kraljevo	Sp00	Kraljevo
Kremlin	Spms	Kremlin
Krusik	Spms	Krusik
Kukes	Sp00	Kukes
Kyrie	Spms	Kyrie
L. Hamilton	Sp00	L. Hamilton
L. Rekarte	Sp00	L. Rekarte
La Caixa	Sp00	La Caixa
La Capella Reial de Catalunya	Sp00	La Capella Reial de Catalunya
La Princesa	Sp00	La Princesa
La Ría	Sp00	La Ría
La estrella misteriosa	Spfs	La estrella misteriosa
La mitad del cielo	Spfs	La mitad del cielo
Lab	Sp00	Lab
Labacolla	Sp00	Labacolla
Laboratorio de Sanidade Exterior de Vigo	Spms	Laboratorio de Sanidade Exterior de Vigo
Lage	Sp00	Lage
Lage Tuñas	Sp00	Lage Tuñas
Laíño	Sp00	Laíño
Lalín	Sp00	Lalín
Lalín-A Estrada	Sp00	Lalín-A Estrada
Lalo	Spm0	Lalo
Lalo F. Mayo	Spm0	Lalo F. Mayo
Lalo García	Spm0	Lalo García
Lalo Gutiérrez	Spm0	Lalo Gutiérrez
Lamas	Sp00	Lamas
Láncara	Sp00	Láncara
Lancelot	Spm0	Lancelot
Landín	Sp00	Landín
Lanzarote	Sp00	Lanzarote
Lapurdi	Sp00	Lapurdi
Laraño	Sp00	Laraño
Laredo	Sp00	Laredo
Laura	Spf0	Laura
Laureano	Spm0	Laureano
Laureano Oubiña	Spm0	Laureano Oubiña
Lavacolla	Sp00	Lavacolla
Laza	Sp00	Laza
Lázaro	Spm0	Lázaro
Lázaro Fernández	Spm0	Lázaro Fernández
Le Monde	Sp00	Le Monde
Leandro	Spm0	Leandro
Leavy	Sp00	Leavy
Lebrú	Spm0	Lebrú
Lecer	Sp00	Lecer
Leeds	Sp00	Leeds
Lei 11/1992	Spfs	Lei 11/1992
Lei Helms-Burton	Spfs	Lei Helms-Burton
Lei de Edificación	Spfs	Lei de Edificación
Lei de xulgamento civil	Spfs	Lei de xulgamento civil
Lei orgánica de dereito a a educación	Spfs	Lei orgánica de dereito a a educación
Leiceaga	Sp00	Leiceaga
Leicester	Sp00	Leicester
Leira	Sp00	Leira
Leis Fidalgo	Sp00	Leis Fidalgo
Lendoiro	Sp00	Lendoiro
León	Sp00	León
Leonardo	Spm0	Leonardo
Leonardo di Caprio	Spm0	Leonardo di Caprio
Leonel	Spm0	Leonel
Leonor	Spf0	Leonor
Leopoldina	Spf0	Leopoldina
Leopoldo	Spm0	Leopoldo
Lerma	Sp00	Lerma
Lesa	Sp00	Lesa
Leticia Costas	Spf0	Leticia Costas
Letizia	Spf0	Letizia
Levante	Sp00	Levante
Lewis Coser	Spm0	Lewis Coser
Lewis Gomourean	Spm0	Lewis Gomourean
Lewis Hamilton	Spm0	Lewis Hamilton
Ley Helmes-Burton	Spfs	Ley Helmes-Burton
Leyma	Sp00	Leyma
Leyma-Lactaria	Spms	Leyma-Lactaria
Líbano	Sp00	Líbano
Libro Branco de Enerxía	Spms	Libro Branco de Enerxía
Libro de Oro de a Cámara de Santiago	Spms	Libro de Oro de a Cámara de Santiago
Lidia	Spf0	Lidia
Limia	Sp00	Limia
Lindín	Sp00	Lindín
Lindsay Kemp	Spm0	Lindsay Kemp
Lino	Spm0	Lino
Lisboa	Sp00	Lisboa
Liverpool	Sp00	Liverpool
Livorno	Sp00	Livorno
Lizarra	Sp00	Lizarra
Llamazares	Sp00	Llamazares
Lleida	Sp00	Lleida
Lluch	Sp00	Lluch
Lobeira	Sp00	Lobeira
Lobos Brancos	Sp00	Lobos Brancos
Lode	Sp00	Lode
Lois	Spm0	Lois
Lois Pérez Castrillo	Spm0	Lois Pérez Castrillo
Lojane	Sp00	Lojane
Lola	Spf0	Lola
Lola Baldrich	Spf0	Lola Baldrich
Lola Beccaria	Spf0	Lola Beccaria
Lola Cruña	Spf0	Lola Cruña
Lola Dopico	Spf0	Lola Dopico
Lola Flores	Spf0	Lola Flores
Lola Folgar	Spf0	Lola Folgar
Lola Herrera	Spf0	Lola Herrera
Lola López	Spf0	Lola López
Lola Lorente	Spf0	Lola Lorente
Lola Ramona	Spf0	Lola Ramona
Lola Varela	Spf0	Lola Varela
Loli	Spf0	Loli
Londres	Sp00	Londres
Lópe	Sp00	Lópe
López	Sp00	López
López Abella	Sp00	López Abella
López Aguilar	Sp00	López Aguilar
López Alegría	Sp00	López Alegría
López Arango	Sp00	López Arango
López Besteiro	Sp00	López Besteiro
López Bourio	Sp00	López Bourio
López Bulla	Sp00	López Bulla
López Chaves	Sp00	López Chaves
López Collado	Sp00	López Collado
López Costa	Sp00	López Costa
López Duarte	Sp00	López Duarte
López Ferreiro	Sp00	López Ferreiro
López Foxo	Sp00	López Foxo
López Franco	Sp00	López Franco
Lopez Garai	Sp00	Lopez Garai
López Garai	Sp00	López Garai
López Garrido	Sp00	López Garrido
López Guerrero	Sp00	López Guerrero
López Iglesias	Sp00	López Iglesias
López Isla	Sp00	López Isla
López Izquierdo	Sp00	López Izquierdo
López Jiménez	Sp00	López Jiménez
López Mella	Sp00	López Mella
López Miranda	Sp00	López Miranda
López Orozco	Sp00	López Orozco
López Ortiz	Sp00	López Ortiz
López Pazos	Sp00	López Pazos
López Peláez	Sp00	López Peláez
López Pérez	Sp00	López Pérez
López Pintos	Sp00	López Pintos
López Rekarte	Sp00	López Rekarte
López Riaño	Sp00	López Riaño
López Rico	Sp00	López Rico
López Rivadulla	Sp00	López Rivadulla
López Rivas	Sp00	López Rivas
López Saco	Sp00	López Saco
López Sanz	Sp00	López Sanz
López Silva	Sp00	López Silva
López Suevos	Sp00	López Suevos
López Torre	Sp00	López Torre
López Torres	Sp00	López Torres
López Vázquez	Sp00	López Vázquez
López Veiga	Sp00	López Veiga
López Vidal	Sp00	López Vidal
López Vilas	Sp00	López Vilas
López Vispo	Sp00	López Vispo
López White	Sp00	López White
López Zubero	Sp00	López Zubero
López de Acebedo, Diego	Spm0	López de Acebedo, Diego
López de Castro	Sp00	López de Castro
López de Lacalle	Sp00	López de Lacalle
López de Neira	Sp00	López de Neira
López de Uralde	Sp00	López de Uralde
López, Pedro	Spm0	López, Pedro
Lorca	Sp00	Lorca
Lorenzo	Spm0	Lorenzo
Los Angeles Daily News	Spms	Los Angeles Daily News
Los Verdes	Spmp	Los Verdes
Los Verdes-Las Izquierdas de los Pueblos	Sp00	Los Verdes-Las Izquierdas de los Pueblos
Losada	Sp00	Losada
Losey	Sp00	Losey
Louis	Spm0	Louis
Louis Gentile	Spm0	Louis Gentile
Lourdes Díaz	Spf0	Lourdes Díaz
Lourdes Domínguez	Spf0	Lourdes Domínguez
Lourdes Hernández	Spf0	Lourdes Hernández
Lourdes Maceiras García	Spf0	Lourdes Maceiras García
Lourdes Méndez	Spf0	Lourdes Méndez
Lourdes Muñoz Santamaría	Spf0	Lourdes Muñoz Santamaría
Lourenzo	Spm0	Lourenzo
Lourizán	Sp00	Lourizán
Loxse	Spfs	Loxse
Loyola de Palacio	Sp00	Loyola de Palacio
Luar	Sp00	Luar
Luar en a Lubre	Sp00	Luar en a Lubre
Lucas	Spm0	Lucas
Luchino Visconti	Spm0	Luchino Visconti
Lucía	Spf0	Lucía
Luciano	Spm0	Luciano
Lucinda	Spf0	Lucinda
Ludolfo Paramio	Spm0	Ludolfo Paramio
Lugo	Sp00	Lugo
Luis	Spm0	Luis
Luís	Spm0	Luís
Luis Boza	Spm0	Luis Boza
Luis Braga de a Cruz	Spm0	Luis Braga de a Cruz
Luis Caramés Viéitez	Spm0	Luis Caramés Viéitez
Luis Carrera	Spm0	Luis Carrera
Luis Carrera Pásaro	Spm0	Luis Carrera Pásaro
Luis Enrique Morado	Spm0	Luis Enrique Morado
Luis Mariñas	Spm0	Luis Mariñas
Luis Mingo	Spm0	Luis Mingo
Luis Parente Parente	Spm0	Luis Parente Parente
Luis Pérez	Spm0	Luis Pérez
Luis Sepúlveda	Spm0	Luis Sepúlveda
Luis Yáñez	Spm0	Luis Yáñez
Luísa	Spf0	Luísa
Luisito	Spm0	Luisito
Lustres Rivas	Sp00	Lustres Rivas
Luton	Sp00	Luton
Luxemburgo	Sp00	Luxemburgo
Luzane	Sp00	Luzane
Luzani	Sp00	Luzani
M. Bartoli	Sp00	M. Bartoli
M. Rivas	Sp00	M. Rivas
M. Santalices	Sp00	M. Santalices
M. Webber	Sp00	M. Webber
M. X. Queizán	Sp00	M. X. Queizán
M.T.F.	Sp00	M.T.F.
MS T	Sp00	MS T
Mabel Lozano	Spf0	Mabel Lozano
Mabel Pérez	Spf0	Mabel Pérez
Mabel Rivera	Spf0	Mabel Rivera
Macario	Spm0	Macario
Maceda	Sp00	Maceda
Macedonia	Sp00	Macedonia
Madeleine Albright	Spf0	Madeleine Albright
Madras	Sp00	Madras
Madrid	Sp00	Madrid
Madrid-autonomías	Sp00	Madrid-autonomías
Magariños	Sp00	Magariños
Magdalena	Sp00	Magdalena
Mahía	Sp00	Mahía
Mailoc	Spm0	Mailoc
Málaga	Sp00	Málaga
Malina Mala	Sp00	Malina Mala
Mallorca	Sp00	Mallorca
Mamadou Kane	Spm0	Mamadou Kane
Manchester	Sp00	Manchester
Mandela	Sp00	Mandela
Manhattan	Sp00	Manhattan
Manoel	Spm0	Manoel
Manolo	Spm0	Manolo
Mans Unidas	Sp00	Mans Unidas
Mans Unidas de Santiago	Sp00	Mans Unidas de Santiago
Manuel	Spm0	Manuel
Manuel Abeledo	Spm0	Manuel Abeledo
Manuel Cabezas	Spm0	Manuel Cabezas
Manuel Chaves	Spm0	Manuel Chaves
Manuel Crescencio	Spm0	Manuel Crescencio
Manuel Crescencio Morán	Spm0	Manuel Crescencio Morán
Manuel Durán Coto	Spm0	Manuel Durán Coto
Manuel F. Vieites	Spm0	Manuel F. Vieites
Manuel Fernández Areal	Spm0	Manuel Fernández Areal
Manuel Fraga	Spm0	Manuel Fraga
Manuel Fraga Iribarne	Spm0	Manuel Fraga Iribarne
Manuel Gómez Tellado	Spm0	Manuel Gómez Tellado
Manuel Lourenzo	Spm0	Manuel Lourenzo
Manuel Méndez	Spm0	Manuel Méndez
Manuel Noya	Spm0	Manuel Noya
Manuel Parga	Spm0	Manuel Parga
Manuel Pérez	Spm0	Manuel Pérez
Manuel Pimentel	Spm0	Manuel Pimentel
Manuela	Spf0	Manuela
Manuela Lema	Spf0	Manuela Lema
Manuela López Besteiro	Spf0	Manuela López Besteiro
Mar Iglesias	Spf0	Mar Iglesias
Maragall	Sp00	Maragall
Marca digital	Spms	Marca digital
Marcelina	Spf0	Marcelina
Marcelino	Spm0	Marcelino
Marcial	Spm0	Marcial
Marcial Magdalena	Spm0	Marcial Magdalena
Marcial Magdalena Torres	Spm0	Marcial Magdalena Torres
Marcide	Spms	Marcide
Marco Antonio	Spm0	Marco Antonio
Marco de Apoio Comunitario 2000-06	Spms	Marco de Apoio Comunitario 2000-06
Marcos	Spm0	Marcos
Marga	Spf0	Marga
Marga Alborés	Spf0	Marga Alborés
Marga Massanet	Spf0	Marga Massanet
Marga Miguens	Spf0	Marga Miguens
Marga Romero	Spf0	Marga Romero
Margarida	Spf0	Margarida
Margarita	Spf0	Margarita
Margarita Barral Martínez	Spf0	Margarita Barral Martínez
Margarita Cardoso	Spf0	Margarita Cardoso
Margarita Fernández	Spf0	Margarita Fernández
Margarita Landín	Spf0	Margarita Landín
Margarita Landín Areal	Spf0	Margarita Landín Areal
Margarita Ledo	Spf0	Margarita Ledo
Margarita Leirachá	Spf0	Margarita Leirachá
Margarita Mariscal	Spf0	Margarita Mariscal
Margarita Montero	Spf0	Margarita Montero
Margarita Otero	Spf0	Margarita Otero
Margarita Pastor	Spf0	Margarita Pastor
Margarita Pastor de Jessen	Spf0	Margarita Pastor de Jessen
Margarita Pérez Herráiz	Spf0	Margarita Pérez Herráiz
Margarita Retuerto	Spf0	Margarita Retuerto
Margarita Robles	Spf0	Margarita Robles
Margarita Rodriguez	Spf0	Margarita Rodriguez
Margarita Soto	Spf0	Margarita Soto
Margarita Uría	Spf0	Margarita Uría
Margarita Vázquez de Parga	Spf0	Margarita Vázquez de Parga
Margarita Xirgu	Spf0	Margarita Xirgu
Margarita de Borbón	Spf0	Margarita de Borbón
Mari	Spf0	Mari
Maria	Spf0	Maria
María	Spf0	María
Maria Callas	Spf0	Maria Callas
Maria Cristina	Spf0	Maria Cristina
María Dolores Bueno Ramírez	Spf0	María Dolores Bueno Ramírez
María García	Spf0	María García
María Jesús Aguirre	Spf0	María Jesús Aguirre
María Jesús Aramburu	Spf0	María Jesús Aramburu
María Luz Ruíz	Spf0	María Luz Ruíz
Maria Manuela Margarido	Spf0	Maria Manuela Margarido
María Mercedes Castaño	Spf0	María Mercedes Castaño
María Milosevic	Spf0	María Milosevic
María San Gil	Spf0	María San Gil
Maria Thomas	Spf0	Maria Thomas
Maria Victoria de la Fuente	Spf0	Maria Victoria de la Fuente
María Xosé Gómez	Spf0	María Xosé Gómez
Maria Xosé Porteiro	Spf0	Maria Xosé Porteiro
María Xosé Rodríguez Galdo	Spf0	María Xosé Rodríguez Galdo
Marián Bañobre	Spf0	Marián Bañobre
Mariano	Spm0	Mariano
Mariano Rajoy	Spm0	Mariano Rajoy
Marín	Sp00	Marín
Mariña	Spf0	Mariña
Mario	Spm0	Mario
Marion King Hubber rober	Spf0	Marion King Hubber rober
Marisa	Spf0	Marisa
Marisa Alén	Spf0	Marisa Alén
Marisa Gil	Spf0	Marisa Gil
Marisa Matias	Spf0	Marisa Matias
Marisa Paderme	Spf0	Marisa Paderme
Marisa Paredes	Spf0	Marisa Paredes
Marisa Rivero Conde	Spf0	Marisa Rivero Conde
Marisa Rodríguez	Spf0	Marisa Rodríguez
Marisa Soleto	Spf0	Marisa Soleto
Marisa Tanzini	Spf0	Marisa Tanzini
Marisol Bueno	Spf0	Marisol Bueno
Marisol López	Spf0	Marisol López
Marisol Soengas	Spf0	Marisol Soengas
Marisol Soneira	Spf0	Marisol Soneira
Marissa	Spf0	Marissa
Marissa Nadler	Spf0	Marissa Nadler
Markov	Sp00	Markov
Marlene Dietrich	Spf0	Marlene Dietrich
Marrocos	Sp00	Marrocos
Marrozos	Sp00	Marrozos
Marta	Spf0	Marta
Marta Diéguez Rodríguez	Spf0	Marta Diéguez Rodríguez
Marta González	Spf0	Marta González
Marta González Manchón	Spf0	Marta González Manchón
Martín	Spm0	Martín
Martin Amis	Spm0	Martin Amis
Martin Codax	Spm0	Martin Codax
Martin Compston	Spm0	Martin Compston
Martin Erdmann	Spm0	Martin Erdmann
Martin Hart	Spm0	Martin Hart
Martin Kessler	Spm0	Martin Kessler
Martin Lindstrom	Spm0	Martin Lindstrom
Martín Llamas Nistal	Spm0	Martín Llamas Nistal
Martin Luther King	Spm0	Martin Luther King
Martin McGuinness	Spm0	Martin McGuinness
Martin Pawley	Spm0	Martin Pawley
Martin Rohde	Spm0	Martin Rohde
Martin Sheen	Spm0	Martin Sheen
Martín Torrijos	Spm0	Martín Torrijos
Martin Weisz	Spm0	Martin Weisz
Martínez	Sp00	Martínez
Martínez Sánchez	Sp00	Martínez Sánchez
Martiño	Spm0	Martiño
Martorell	Sp00	Martorell
Martti Ahtisaar	Spm0	Martti Ahtisaar
Martti Ahtisaari	Spm0	Martti Ahtisaari
Maruja	Spf0	Maruja
Maruxa	Spf0	Maruxa
Maruxiña	Spf0	Maruxiña
Mary	Spf0	Mary
Mary Robinson	Spf0	Mary Robinson
Maside	Sp00	Maside
Masma	Sp00	Masma
Masó	Sp00	Masó
Massimo DÁlema	Spm0	Massimo DÁlema
Máster de Administración Financeira e Tributaria	Spms	Máster de Administración Financeira e Tributaria
Matán Vilnaí	Sp00	Matán Vilnaí
Matanzas	Sp00	Matanzas
Mateo	Spm0	Mateo
Materno Infantil	Spms	Materno Infantil
Matilde	Spf0	Matilde
Matutes	Sp00	Matutes
Mauricio	Spm0	Mauricio
Mauro	Spm0	Mauro
Max	Spm0	Max
Maximinio Zumalave	Spm0	Maximinio Zumalave
Maximino	Spm0	Maximino
Máximo García	Spm0	Máximo García
Mayor	Sp00	Mayor
Mayor Oreja	Sp00	Mayor Oreja
Mayor Zaragoza	Sp00	Mayor Zaragoza
Mayoyo	Sp00	Mayoyo
McLaren	Sp00	McLaren
Medicina	Sp00	Medicina
Médicos Internos Residentes	Spmp	Médicos Internos Residentes
Médicos do Mundo	Sp00	Médicos do Mundo
Médicos sen Fronteiras	Sp00	Médicos sen Fronteiras
Medio Ambiente	Sp00	Medio Ambiente
Medio Ambiente de Galicia 1999	Sp00	Medio Ambiente de Galicia 1999
Mediterráneo	Spms	Mediterráneo
Medosevac	Sp00	Medosevac
Medtec	Spms	Medtec
Meira	Sp00	Meira
Meixide Prado	Sp00	Meixide Prado
Meixoeiro	Spms	Meixoeiro
Mejuto	Sp00	Mejuto
Mejuto Leis, Vicente	Spm0	Mejuto Leis, Vicente
Melchor	Spm0	Melchor
Melgaso	Sp00	Melgaso
Meliá	Spfs	Meliá
Melide	Sp00	Melide
Melilla	Sp00	Melilla
Melón	Sp00	Melón
Memento	Sp00	Memento
Menchu	Spf0	Menchu
Menchu Lamas	Spf0	Menchu Lamas
Méndez	Sp00	Méndez
Méndez Ferrín	Sp00	Méndez Ferrín
Menéndez	Sp00	Menéndez
Menéndez Flores	Sp00	Menéndez Flores
Menéndez Pidal	Sp00	Menéndez Pidal
Menéndez Valdés	Sp00	Menéndez Valdés
Mercash Sar	Sp00	Mercash Sar
Mercé	Spf0	Mercé
Mercedes	Spf0	Mercedes
Mercedes Peón	Spf0	Mercedes Peón
Mérida	Sp00	Mérida
Merino	Sp00	Merino
Merlín	Spm0	Merlín
Merrill Lynch	Sp00	Merrill Lynch
Mes de a Cultura	Spms	Mes de a Cultura
Mesa Sectorial do Ensino	Spfs	Mesa Sectorial do Ensino
Mesa de a Cámara	Spfs	Mesa de a Cámara
Mesa por a Normalización Lingüística	Spfs	Mesa por a Normalización Lingüística
Mesonero	Sp00	Mesonero
Mesoneros	Sp00	Mesoneros
Mestre Braghetone	Spms	Mestre Braghetone
Métodos de estatística e de investigación operativa	Spms	Métodos de estatística e de investigación operativa
México	Sp00	México
Miami	Sp00	Miami
Michael	Spm0	Michael
Michael Atiyah	Spm0	Michael Atiyah
Michael Ballack	Spm0	Michael Ballack
Michael Caine	Spm0	Michael Caine
Michael Caplan	Spm0	Michael Caplan
Michael Corleone	Spm0	Michael Corleone
Michael Cunningham	Spm0	Michael Cunningham
Michael Douglas	Spm0	Michael Douglas
Michael Doyle	Spm0	Michael Doyle
Michael Fassbender	Spm0	Michael Fassbender
Michael Felman	Spm0	Michael Felman
Michael Gira	Spm0	Michael Gira
Michael Jackson	Spm0	Michael Jackson
Michael Jordan	Spm0	Michael Jordan
Michael Klare	Spm0	Michael Klare
Michael Laudrup	Spm0	Michael Laudrup
Michael Leonhart	Spm0	Michael Leonhart
Michael López	Spm0	Michael López
Michael Mann	Spm0	Michael Mann
Michael McDermott	Spm0	Michael McDermott
Michael Moore	Spm0	Michael Moore
Michael Novak	Spm0	Michael Novak
Michael P	Spm0	Michael P
Michael Phelps	Spm0	Michael Phelps
Michael Pitt	Spm0	Michael Pitt
Michael Ruffin	Spm0	Michael Ruffin
Michael Schubat	Spm0	Michael Schubat
Michael Schumacher	Spm0	Michael Schumacher
Michael Stipe	Spm0	Michael Stipe
Michael Walzer	Spm0	Michael Walzer
Michael Widenius	Spm0	Michael Widenius
Michael Winner	Spm0	Michael Winner
Michael Winterbottom	Spm0	Michael Winterbottom
Michael Zammit	Spm0	Michael Zammit
Michaëlis	Spfs	Michaëlis
Michavila	Sp00	Michavila
Michel	Spm0	Michel
Míchel	Spm0	Míchel
Míchel Alonso	Spm0	Míchel Alonso
Michel Camdessus	Spm0	Michel Camdessus
Michel Collon	Spm0	Michel Collon
Michel Crichton	Spm0	Michel Crichton
Míchel Domínguez	Spm0	Míchel Domínguez
Michel Foucault	Spm0	Michel Foucault
Michel Gabaudan	Spm0	Michel Gabaudan
Michel Gondry	Spm0	Michel Gondry
Michel Houellebecq	Spm0	Michel Houellebecq
Michel Léveque	Spm0	Michel Léveque
Michel Maffesoli	Spm0	Michel Maffesoli
Michel Odent	Spm0	Michel Odent
Michel Platini	Spm0	Michel Platini
Microsoft	Sp00	Microsoft
Mig	Sp00	Mig
Miguel	Spm0	Miguel
Miguel Ángel	Spm0	Miguel Ángel
Miguel Ángel Capón	Spm0	Miguel Ángel Capón
Miguel Chana	Spm0	Miguel Chana
Miguel Chana Martín	Spm0	Miguel Chana Martín
Miguel Herrero	Spm0	Miguel Herrero
Miguel Littin	Spm0	Miguel Littin
Miguélez	Sp00	Miguélez
Mike	Spm0	Mike
Mike Darnell	Spm0	Mike Darnell
Mike Huckabee	Spm0	Mike Huckabee
Mike Kelley	Spm0	Mike Kelley
Mike Laing	Spm0	Mike Laing
Mike Leigh	Spm0	Mike Leigh
Mike Mills	Spm0	Mike Mills
Mike Muscala	Spm0	Mike Muscala
Mike Nedo	Spm0	Mike Nedo
Mike Nichols	Spm0	Mike Nichols
Mike Valentine	Spm0	Mike Valentine
Mikel Aguirresarobe	Spm0	Mikel Aguirresarobe
Mikel Buesa	Spm0	Mikel Buesa
Mikel González González de Heredia	Spm0	Mikel González González de Heredia
Mikel Ibarquen Argala	Spm0	Mikel Ibarquen Argala
Mikel Prieto	Spm0	Mikel Prieto
Mikel Sueskun	Spm0	Mikel Sueskun
Milán	Sp00	Milán
Milladoiro	Sp00	Milladoiro
Milo Taboada	Spm0	Milo Taboada
Milosevic	Sp00	Milosevic
Milstein	Sp00	Milstein
Milucha	Spf0	Milucha
Mingo	Sp00	Mingo
Minguiños	Spm0	Minguiños
Minia	Spf0	Minia
Ministerio	Spms	Ministerio
Ministerio Federal de Asuntos Exteriores	Spms	Ministerio Federal de Asuntos Exteriores
Ministerio de Administracións Públicas	Spms	Ministerio de Administracións Públicas
Ministerio de Agricultura	Spms	Ministerio de Agricultura
Ministerio de Economía	Spms	Ministerio de Economía
Ministerio de Educación	Spms	Ministerio de Educación
Ministerio de Fomento	Spms	Ministerio de Fomento
Ministerio de Industria	Spms	Ministerio de Industria
Ministerio de Medio Ambiente	Spms	Ministerio de Medio Ambiente
Ministerio de Pesca	Spms	Ministerio de Pesca
Ministerio de Sanidade	Spms	Ministerio de Sanidade
Ministerio para as Administracións Públicas	Spms	Ministerio para as Administracións Públicas
Minnesotta	Sp00	Minnesotta
Miño	Spms	Miño
Miquel Iceta	Spm0	Miquel Iceta
Mir	Spms	Mir
Mira Lema	Spf0	Mira Lema
Miranda	Sp00	Miranda
Miras	Sp00	Miras
Mireya Moscoso	Spf0	Mireya Moscoso
Missa Salisburgensis	Sp00	Missa Salisburgensis
Mitch	Spms	Mitch
Mitrovica	Sp00	Mitrovica
Mladjan Dinkic	Spm0	Mladjan Dinkic
Mme. Bovary	Spf0	Mme. Bovary
Moaña	Sp00	Moaña
Modesto	Spm0	Modesto
Moisés	Spm0	Moisés
Mokasin	Sp00	Mokasin
Molina	Sp00	Molina
Momo	Spm0	Momo
Mónaco	Sp00	Mónaco
Moncho	Spm0	Moncho
Moncloa	Sp00	Moncloa
Mondoñedo	Sp00	Mondoñedo
Mondragón	Sp00	Mondragón
Monforte	Sp00	Monforte
Monforte de Lemos	Sp00	Monforte de Lemos
Mónica	Spf0	Mónica
Mónica Ridruejo	Spf0	Mónica Ridruejo
Monsanto	Sp00	Monsanto
Monserrat	Spf0	Monserrat
Monte Palomar	Spms	Monte Palomar
Monte Porreiro	Sp00	Monte Porreiro
Monte de a Condesa	Spfs	Monte de a Condesa
Monte do Gozo	Spms	Monte do Gozo
Montecelo	Sp00	Montecelo
Montecelo	Spms	Montecelo
Montederramo	Sp00	Montederramo
Montehery	Sp00	Montehery
Montenegro	Sp00	Montenegro
Montero	Sp00	Montero
Montero Prego	Sp00	Montero Prego
Montero Ríos	Sp00	Montero Ríos
Montero Santalha	Sp00	Montero Santalha
Montero Vaz	Sp00	Montero Vaz
Monterrei	Sp00	Monterrei
Monterroso	Sp00	Monterroso
Montevideo	Sp00	Montevideo
Montilla	Sp00	Montilla
Montoro	Sp00	Montoro
Moore	Sp00	Moore
Morán	Sp00	Morán
Moreiras	Sp00	Moreiras
Morina	Sp00	Morina
Morte en Venecia	Sp00	Morte en Venecia
Mos	Sp00	Mos
Moscoca	Sp00	Moscoca
Moscoso	Sp00	Moscoso
Moscova	Sp00	Moscova
Mosquera	Sp00	Mosquera
Mosquera Pazos	Sp00	Mosquera Pazos
Mosquera Rey	Sp00	Mosquera Rey
Mourente	Sp00	Mourente
Movemento de Solidariedade con Cuba	Spms	Movemento de Solidariedade con Cuba
Movemento por a Paz , o Desarmamento e a Liberdade	Spms	Movemento por a Paz , o Desarmamento e a Liberdade
Mozart	Sp00	Mozart
Mrcajevci	Sp00	Mrcajevci
Múgica	Sp00	Múgica
Múgica Herzog	Sp00	Múgica Herzog
Muíños	Sp00	Muíños
Muñiz	Sp00	Muñiz
Muñoz	Sp00	Muñoz
Muñoz Medina	Sp00	Muñoz Medina
Muñoz Oya	Sp00	Muñoz Oya
Muras	Sp00	Muras
Murcia	Sp00	Murcia
Muros	Sp00	Muros
Muros-Noia	Sp00	Muros-Noia
Museo Masó	Spm0	Museo Masó
Museo de as Peregrinacións	Spms	Museo de as Peregrinacións
Museo do Prado	Spms	Museo do Prado
Mutti	Sp00	Mutti
Muxía	Sp00	Muxía
MySpace	Sp00	MySpace
N-634	Spfs	N-634
N-VI	Spfs	N-VI
N. Abbot	Sp00	N. Abbot
Nacional Center For Simulation	Spfs	Nacional Center For Simulation
Nacións Unidas	Sp00	Nacións Unidas
Nacións Unidas	Spfp	Nacións Unidas
Nalini T. Suthenthiraja	Spf0	Nalini T. Suthenthiraja
Namibia	Sp00	Namibia
Nancho Novo	Spm0	Nancho Novo
Nandiño	Spm0	Nandiño
Naomi Campbell	Spf0	Naomi Campbell
Naomi Klein	Spf0	Naomi Klein
Naomi Watts	Spf0	Naomi Watts
Napoleón	Spm0	Napoleón
Nápoles	Sp00	Nápoles
Narciso	Spm0	Narciso
Natalia	Spf0	Natalia
Navajas	Sp00	Navajas
Navarra	Sp00	Navarra
Navegación	Sp00	Navegación
Navia de Suarna	Sp00	Navia de Suarna
Nazaret López	Spf0	Nazaret López
Nazim Shtino	Spm0	Nazim Shtino
Negreira	Sp00	Negreira
Nelson Mandela	Spm0	Nelson Mandela
Nemesio	Spm0	Nemesio
Néstor	Spm0	Néstor
Néstor Armesto	Spm0	Néstor Armesto
Néstor Kirchner	Spm0	Néstor Kirchner
Néstor Luján	Spm0	Néstor Luján
Néstor Rego	Spm0	Néstor Rego
Néstor Valcárcel	Spm0	Néstor Valcárcel
Netanyahu	Sp00	Netanyahu
Netscape	Sp00	Netscape
Neuroloxía	Sp00	Neuroloxía
New York Daily News	Spms	New York Daily News
Newry	Sp00	Newry
News	Sp00	News
Nicanor	Spm0	Nicanor
Nick Cave	Spm0	Nick Cave
Nick Clegg	Spm0	Nick Clegg
Nick Ray	Spm0	Nick Ray
Nick Ut	Spm0	Nick Ut
Nick Waterhouse	Spm0	Nick Waterhouse
Nicolao	Spm0	Nicolao
Nicolás	Spm0	Nicolás
Nicolás Redondo	Spm0	Nicolás Redondo
Nietsche	Sp00	Nietsche
Nieves	Spf0	Nieves
Nieves Cuellar	Spf0	Nieves Cuellar
Nieves Domínguez	Spf0	Nieves Domínguez
Nieves Herrero	Spf0	Nieves Herrero
Nieves Lagares	Spf0	Nieves Lagares
Nieves Vázquez	Spf0	Nieves Vázquez
Nigrán	Sp00	Nigrán
Nikolái Aksenenko	Spm0	Nikolái Aksenenko
Niñodaguia	Sp00	Niñodaguia
Nis	Sp00	Nis
Nivardo	Spm0	Nivardo
Nixon	Sp00	Nixon
Noé	Spm0	Noé
Noelia	Spf0	Noelia
Noelia López	Spf0	Noelia López
Nogueira	Sp00	Nogueira
Noia	Sp00	Noia
Noriega	Sp00	Noriega
Noriega Varela	Sp00	Noriega Varela
Noruega	Sp00	Noruega
Nós	Sp00	Nós
Nosa Señora de a Concepción	Spf0	Nosa Señora de a Concepción
Nostián	Sp00	Nostián
Nottingham	Sp00	Nottingham
Nova York	Sp00	Nova York
Novas Xeracións do PP de Galicia	Spfp	Novas Xeracións do PP de Galicia
Novoneyra	Sp00	Novoneyra
Noya	Sp00	Noya
Núcleo Vello	Spms	Núcleo Vello
Nuestra Señora de la Esperanza	Spfs	Nuestra Señora de la Esperanza
Nueva Izquierda	Sp00	Nueva Izquierda
Nueva Nación	Sp00	Nueva Nación
Núñez	Sp00	Núñez
Núñez Morgades	Sp00	Núñez Morgades
Nuria	Spf0	Nuria
Nuria Amat	Spf0	Nuria Amat
Nuria Arca	Spf0	Nuria Arca
Nuria Benedito	Spf0	Nuria Benedito
Nuria Colmenero	Spf0	Nuria Colmenero
Nuria Díaz	Spf0	Nuria Díaz
Nuria Espert	Spf0	Nuria Espert
Nuria Esther Arcas Fernández	Spf0	Nuria Esther Arcas Fernández
Nuria González	Spf0	Nuria González
Nuria Roca	Spf0	Nuria Roca
Nuria Rodríguez	Spf0	Nuria Rodríguez
Nuria Rodríguez Pedreira	Spf0	Nuria Rodríguez Pedreira
Nuria Varela Portas	Spf0	Nuria Varela Portas
Nuria de Gispert	Spf0	Nuria de Gispert
O Barco	Sp00	O Barco
O Barco de Valdeorras	Sp00	O Barco de Valdeorras
O Bolo	Sp00	O Bolo
O Carballiño	Sp00	O Carballiño
O Correo Galego	Spms	O Correo Galego
O Golán	Sp00	O Golán
O Gozo	Spms	O Gozo
O Grove	Sp00	O Grove
O Incio	Sp00	O Incio
O Líbano	Sp00	O Líbano
O Meixoeiro	Spms	O Meixoeiro
O Morrazo	Sp00	O Morrazo
O Obradoiro	Sp00	O Obradoiro
O Obradoiro	Spms	O Obradoiro
O Portiño	Sp00	O Portiño
O Porto	Sp00	O Porto
O Porto-Vigo	Spfs	O Porto-Vigo
O Pulpo	Sp00	O Pulpo
O Servente	Sp00	O Servente
O Soho	Sp00	O Soho
O Val Miñor	Sp00	O Val Miñor
O Vaticano	Sp00	O Vaticano
O Vicedo	Sp00	O Vicedo
O cabaleiro de a man en o peito	Spms	O cabaleiro de a man en o peito
O porteiro de noite	Sp00	O porteiro de noite
O pulpo	Sp00	O pulpo
O servente	Sp00	O servente
O son do ar	Sp00	O son do ar
Obama	Sp00	Obama
Oberlin	Sp00	Oberlin
Obras Públicas	Sp00	Obras Públicas
Observatorio Astrofísico Especial	Spms	Observatorio Astrofísico Especial
Observatorio de Kitt Peak	Spms	Observatorio de Kitt Peak
Observatorio do Teide	Spms	Observatorio do Teide
Occidente	Sp00	Occidente
Ochoa Ledesma	Sp00	Ochoa Ledesma
Octavio	Spm0	Octavio
Octavio Lois	Spm0	Octavio Lois
Octavio Lois Amado	Spm0	Octavio Lois Amado
Octavio Paz	Spm0	Octavio Paz
Octavio San Martín	Spm0	Octavio San Martín
Octavio Vázquez	Spm0	Octavio Vázquez
Oda	Spfs	Oda
Oded Ben Ami	Spm0	Oded Ben Ami
Oficina Consular para Galicia	Spfs	Oficina Consular para Galicia
Oficina Municipal de Atención a o Rural	Spfs	Oficina Municipal de Atención a o Rural
Oficina de Presuposto	Spfs	Oficina de Presuposto
Oficina de Xustificación de a Difusión	Spfs	Oficina de Xustificación de a Difusión
Ogata	Sp00	Ogata
Ohio	Sp00	Ohio
Olaia Baleato	Sp00	Olaia Baleato
Olaia Fernández	Spf0	Olaia Fernández
Olé	Sp00	Olé
Oleg Sisúyev	Spm0	Oleg Sisúyev
Olegaria	Spf0	Olegaria
Olegario	Spm0	Olegario
Oleiros	Sp00	Oleiros
Olga	Spf0	Olga
Olga Fontán	Spf0	Olga Fontán
Olga Guirao	Spf0	Olga Guirao
Olga Novo	Spf0	Olga Novo
Olga Patiño	Spf0	Olga Patiño
Olga Savary	Spf0	Olga Savary
Olga Varela	Spf0	Olga Varela
Olga Vilar	Spf0	Olga Vilar
Oliver	Spm0	Oliver
Omar	Spm0	Omar
Omar Bravo	Spm0	Omar Bravo
Omar Khayyam	Spm0	Omar Khayyam
Omar Moalim	Spm0	Omar Moalim
Omar Moussabampi	Spm0	Omar Moussabampi
Omar Reygadas Rojas	Spm0	Omar Reygadas Rojas
Omar Torrijos	Spm0	Omar Torrijos
Omni, alarma nuclear	Sp00	Omni, alarma nuclear
Orballo de media noite	Sp00	Orballo de media noite
Orde de Santiago	Spfs	Orde de Santiago
Ordenación Educativa	Sp00	Ordenación Educativa
Ordes	Sp00	Ordes
Ordóñez	Sp00	Ordóñez
Orestes Suárez	Spm0	Orestes Suárez
Organización	Sp00	Organización
Organización Impulsora dos Discapacitados	Spfs	Organización Impulsora dos Discapacitados
Organización Internacional de Migracións	Spfs	Organización Internacional de Migracións
Organización de as Nacións Unidas para a Educación a Ciencia e a Cultura	Spfs	Organización de as Nacións Unidas para a Educación a Ciencia e a Cultura
Organización do Tratado do Atlántico Norte	Spfs	Organización do Tratado do Atlántico Norte
Organización para a Liberación de Palestina	Spfs	Organización para a Liberación de Palestina
Organización para a Seguridade e Cooperación Europea	Spfs	Organización para a Seguridade e Cooperación Europea
Orientación	Sp00	Orientación
Orlandiño	Spm0	Orlando
Orljane	Sp00	Orljane
Ornella Mutti	Spf0	Ornella Mutti
Orozco	Sp00	Orozco
Orquesta Barroca de Sevilla	Sp00	Orquesta Barroca de Sevilla
Orquestra Filharmónica de Brno	Sp00	Orquestra Filharmónica de Brno
Orquestra de Cámara Galega	Spfs	Orquestra de Cámara Galega
Ortega	Sp00	Ortega
Ortega Cano	Sp00	Ortega Cano
Ortega y Gasset	Sp00	Ortega y Gasset
Ortigueira	Sp00	Ortigueira
Ortodisca	Sp00	Ortodisca
Orzamentos Xerais do Estado	Spmp	Orzamentos Xerais do Estado
Orzán	Sp00	Orzán
Os Ánxeles	Sp00	Os Ánxeles
Os Balcáns	Sp00	Os Balcáns
Os Balcáns	Spmp	Os Balcáns
Óscar	Spm0	Óscar
Oseira	Sp00	Oseira
Oslo	Sp00	Oslo
Otegi	Sp00	Otegi
Otero	Sp00	Otero
Otero Pedrayo	Sp00	Otero Pedrayo
Otilia	Spf0	Otilia
Oubiña	Sp00	Oubiña
Ourense	Sp00	Ourense
Ourense-Lubiá	Sp00	Ourense-Lubiá
Ourense-Santiago	Sp00	Ourense-Santiago
Ovidio	Spm0	Ovidio
Oviedo	Sp00	Oviedo
P. T. Anderson	Sp00	P. T. Anderson
Pablo	Spm0	Pablo
Pablo González Moreiras	Spm0	Pablo González Moreiras
Pablo Iglesias	Spm0	Pablo Iglesias
Pablo Molins	Spm0	Pablo Molins
Pablo Vaamonde	Spm0	Pablo Vaamonde
Pacífico	Sp00	Pacífico
Paco	Spm0	Paco
Paco Vázquez	Spm0	Paco Vázquez
Pacto de Estella	Spms	Pacto de Estella
Pacto de Toledo	Spms	Pacto de Toledo
Pacto sobre o Emprego	Spms	Pacto sobre o Emprego
Pacto sobre o emprego	Spms	Pacto sobre o emprego
Paderne de Allariz	Sp00	Paderne de Allariz
Padornelo	Sp00	Padornelo
Padrón	Sp00	Padrón
Paio	Spm0	Paio
País Basco	Sp00	País Basco
Palacio Real	Spms	Palacio Real
Palacio de Congresos de Madrid	Spms	Palacio de Congresos de Madrid
Palacio de Congresos de Santiago	Spms	Palacio de Congresos de Santiago
Palacio de Xelmírez	Spms	Palacio de Xelmírez
Palas	Sp00	Palas
Palencia	Sp00	Palencia
Palestina	Sp00	Palestina
Palmira	Spf0	Palmira
Palmou	Sp00	Palmou
Paloma	Spf0	Paloma
Paloma Fernández	Spf0	Paloma Fernández
Paloma Josse	Spf0	Paloma Josse
Paloma Maneiro	Spf0	Paloma Maneiro
Paloma Navares	Spf0	Paloma Navares
Paloma Notario	Spf0	Paloma Notario
Paloma Pérez de Campos Blanche	Spf0	Paloma Pérez de Campos Blanche
Paloma San Basilio	Spf0	Paloma San Basilio
Pamela	Spf0	Pamela
Pampín	Sp00	Pampín
Pamplona	Sp00	Pamplona
Panamá	Sp00	Panamá
Panasonic	Sp00	Panasonic
Panasonic Toughbook	Sp00	Panasonic Toughbook
Panasonic Toyota	Sp00	Panasonic Toyota
Pantón	Sp00	Pantón
Papantoniu	Sp00	Papantoniu
Paquiño	Spm0	Paquiño
Parada de Sil	Sp00	Parada de Sil
Paradela	Sp00	Paradela
Parador Nacional de Baiona	Spms	Parador Nacional de Baiona
Paradores	Sp00	Paradores
Paradores de Turismo	Sp00	Paradores de Turismo
Pardo Argüeso, Andrés	Spm0	Pardo Argüeso, Andrés
Pardo Bazán	Sp00	Pardo Bazán
Pardo Sola	Sp00	Pardo Sola
Pardo de Castro, Antonio	Spm0	Pardo de Castro, Antonio
Pardo de Castro, Xohán	Spm0	Pardo de Castro, Xohán
Pardo de Guevara	Sp00	Pardo de Guevara
Pardo de Vera	Sp00	Pardo de Vera
Parga	Sp00	Parga
Parga Pondal	Sp00	Parga Pondal
París	Sp00	París
Parker	Sp00	Parker
Parlamento	Spms	Parlamento
Parlamento Europeo	Spms	Parlamento Europeo
Parlamento de Cataluña	Spms	Parlamento de Cataluña
Parlamento de Galicia	Spms	Parlamento de Galicia
Parmalat	Sp00	Parmalat
Parque Europa	Spms	Parque Europa
Partido Comunista	Spms	Partido Comunista
Partido Nacionalista Basco	Spms	Partido Nacionalista Basco
Partido Popular	Sp00	Partido Popular
Partido Popular	Spms	Partido Popular
Partido Popular Europeo	Spms	Partido Popular Europeo
Partido Socialista	Spms	Partido Socialista
Partido Socialista Obreiro Español	Spms	Partido Socialista Obreiro Español
Partido Socialista Serbio	Spms	Partido Socialista Serbio
Partido Socialista de Galicia	Spms	Partido Socialista de Galicia
Partido Unionista do Úlster	Spms	Partido Unionista do Úlster
Partido de Deus	Sp00	Partido de Deus
Partido do Congreso	Spm0	Partido do Congreso
Pasarón	Sp00	Pasarón
Pascual	Sp00	Pascual
Pascual	Spm0	Pascual
Pascual Llorens	Sp00	Pascual Llorens
Pascuala	Spf0	Pascuala
Paseo de Estremadura	Spms	Paseo de Estremadura
Paseo de a Castellana	Spms	Paseo de a Castellana
Patricia	Spf0	Patricia
Patxi López	Spm0	Patxi López
Patxi Salinas	Spm0	Patxi Salinas
Patxi Valera	Spm0	Patxi Valera
Patxi Villanueva	Spm0	Patxi Villanueva
Paul	Spm0	Paul
Paul Aúguez	Spm0	Paul Aúguez
Paul Auster	Spm0	Paul Auster
Paul Bilbao	Spm0	Paul Bilbao
Paul Bilbao Sarria	Spm0	Paul Bilbao Sarria
Paul Bocuse	Spm0	Paul Bocuse
Paul Bowles	Spm0	Paul Bowles
Paul Bremer	Spm0	Paul Bremer
Paul Celan	Spm0	Paul Celan
Paul Condon	Spm0	Paul Condon
Paul Delarue	Spm0	Paul Delarue
Paul Eluard	Spm0	Paul Eluard
Paul Esswood	Spm0	Paul Esswood
Paul Ferguson	Spm0	Paul Ferguson
Paul Fuster	Spm0	Paul Fuster
Paul Garde	Spm0	Paul Garde
Paul Graham	Spm0	Paul Graham
Paul Haggis	Spm0	Paul Haggis
Paul Klee	Spm0	Paul Klee
Paul Krugman	Spm0	Paul Krugman
Paul Lafargue	Spm0	Paul Lafargue
Paul Le Coq	Spm0	Paul Le Coq
Paul M. Nurse	Spm0	Paul M. Nurse
Paul McCartney	Spm0	Paul McCartney
Paul Newman	Spm0	Paul Newman
Paul Niclen	Spm0	Paul Niclen
Paul Poupard	Spm0	Paul Poupard
Paul Preston	Spm0	Paul Preston
Paul Rayment	Spm0	Paul Rayment
Paul Reverdy	Spm0	Paul Reverdy
Paul Ricoeur	Spm0	Paul Ricoeur
Paul Schrader	Spm0	Paul Schrader
Paul Simon	Spm0	Paul Simon
Paul Strand	Spm0	Paul Strand
Paul Valery	Spm0	Paul Valery
Paul Valéry	Spm0	Paul Valéry
Paul Vallée	Spm0	Paul Vallée
Paul Weller	Spm0	Paul Weller
Paul Wolfowitz	Spm0	Paul Wolfowitz
Paul Woods	Spm0	Paul Woods
Paula	Spf0	Paula
Paula Guedini	Spf0	Paula Guedini
Paulo	Spm0	Paulo
Pavillón do Gatañal	Spms	Pavillón do Gatañal
Paz	Spf0	Paz
Pazo Museo Otero Pedrayo	Spms	Pazo Museo Otero Pedrayo
Pazo Universitario dos deportes	Spms	Pazo Universitario dos deportes
Pazo de Fonseca	Spms	Pazo de Fonseca
Pazo de Raxoi	Spms	Pazo de Raxoi
Pazo dos deportes Paco Paz	Spms	Pazo dos deportes Paco Paz
Pazos Torres	Sp00	Pazos Torres
Pearce	Sp00	Pearce
Pec	Sp00	Pec
Pedro	Spm0	Pedro
Pedro Alfonso Ocho Ledesma	Spm0	Pedro Alfonso Ocho Ledesma
Pedro León Camacho	Spm0	Pedro León Camacho
Pedro Molina	Spm0	Pedro Molina
Pedro Moya	Spm0	Pedro Moya
Pedro Navarrete	Spm0	Pedro Navarrete
Pedro Núñez Morgades	Spm0	Pedro Núñez Morgades
Pedro Sanz	Spm0	Pedro Sanz
Pedro Soler	Spm0	Pedro Soler
Pedro álvarez Osorio	Spm0	Pedro álvarez Osorio
Pedro e mais o lobo	Sp00	Pedro e mais o lobo
Pedrosa	Sp00	Pedrosa
Pedroso	Sp00	Pedroso
Pegaso	Sp00	Pegaso
Peinador	Sp00	Peinador
Pellegrini	Sp00	Pellegrini
Pemán	Sp00	Pemán
Penélope	Spf0	Penélope
Penélope Cruz	Spf0	Penélope Cruz
Pentágono	Spms	Pentágono
Pentium	Sp00	Pentium
Pepa	Spf0	Pepa
Pepe	Spm0	Pepe
Pepiño	Spm0	Pepiño
Pequín	Sp00	Pequín
Percival	Spm0	Percival
Percy Bisshe Shelley	Spm0	Percy Bisshe Shelley
Peregrinacións	Sp00	Peregrinacións
Pereiras-A Venda do Río	Sp00	Pereiras-A Venda do Río
Pereiro de Aguiar	Sp00	Pereiro de Aguiar
Peres	Sp00	Peres
Pérez	Sp00	Pérez
Pérez Alberti	Sp00	Pérez Alberti
Pérez Alonso	Sp00	Pérez Alonso
Pérez Barreiro	Sp00	Pérez Barreiro
Pérez Bouza	Sp00	Pérez Bouza
Pérez Casal	Sp00	Pérez Casal
Pérez Castrillo	Sp00	Pérez Castrillo
Pérez Cirera	Sp00	Pérez Cirera
Pérez Docampo	Sp00	Pérez Docampo
Pérez Fojón	Sp00	Pérez Fojón
Pérez Gómez	Sp00	Pérez Gómez
Pérez Lago	Sp00	Pérez Lago
Pérez Lorenzo	Sp00	Pérez Lorenzo
Pérez Mariño	Sp00	Pérez Mariño
Perez Mariño, Ventura	Spm0	Perez Mariño, Ventura
Pérez Maroño	Sp00	Pérez Maroño
Pérez Marugán	Sp00	Pérez Marugán
Pérez Mayo	Sp00	Pérez Mayo
Pérez Moreira	Sp00	Pérez Moreira
Pérez Moreiras	Sp00	Pérez Moreiras
Pérez Oliva	Sp00	Pérez Oliva
Pérez Orozco	Sp00	Pérez Orozco
Pérez Parga	Sp00	Pérez Parga
Pérez Prieto	Sp00	Pérez Prieto
Pérez Quevedo	Sp00	Pérez Quevedo
Pérez Reverte	Sp00	Pérez Reverte
Pérez Rodríguez	Sp00	Pérez Rodríguez
Pérez Roque	Sp00	Pérez Roque
Pérez Rosón	Sp00	Pérez Rosón
Pérez Rubalcaba	Sp00	Pérez Rubalcaba
Pérez Rumbao	Sp00	Pérez Rumbao
Pérez Sáenz	Sp00	Pérez Sáenz
Pérez Sáenz	Sp00	Pérez Sáenz
Pérez Sandar	Sp00	Pérez Sandar
Pérez Subías	Sp00	Pérez Subías
Pérez Touriño	Sp00	Pérez Touriño
Pérez Varela	Sp00	Pérez Varela
Pérez Vicente	Sp00	Pérez Vicente
Pérez Vidal	Sp00	Pérez Vidal
Pérez Villamil	Sp00	Pérez Villamil
Pérez de Bricio	Sp00	Pérez de Bricio
Pérez de Cuéllar	Sp00	Pérez de Cuéllar
Pérez de Juan	Sp00	Pérez de Juan
Pérez, Casilda	Spf0	Pérez, Casilda
Perfecto	Spm0	Perfecto
Perpetua	Spf0	Perpetua
Perry	Sp00	Perry
Persoal	Sp00	Persoal
Perú	Sp00	Perú
Pesca	Sp00	Pesca
Pesca I	Sp00	Pesca I
Pete	Spm0	Pete
Peter Handke	Spm0	Peter Handke
Peterberg	Sp00	Peterberg
Philarmonía Orchestra	Sp00	Philarmonía Orchestra
Phillips-Morris	Sp00	Phillips-Morris
Phoenix	Sp00	Phoenix
Picacho	Sp00	Picacho
Picacho	Spms	Picacho
Pilar	Spf0	Pilar
Pilar Farjas	Spf0	Pilar Farjas
Pilar García Negro	Spf0	Pilar García Negro
Pimentel	Sp00	Pimentel
Piñeiro	Sp00	Piñeiro
Pinochet	Sp00	Pinochet
Piqué	Sp00	Piqué
Pita	Sp00	Pita
Pittsburgh	Sp00	Pittsburgh
Plan	Spms	Plan
Plan Marshall	Spms	Plan Marshall
Plan de Autoprotección	Spms	Plan de Autoprotección
Plan de Emprego Xuvenil	Spms	Plan de Emprego Xuvenil
Plan de Informatización Integral de a Administración Xudicial	Spms	Plan de Informatización Integral de a Administración Xudicial
Plan xeral de ordenación urbana	Spm0	Plan xeral de ordenación urbana
Plataforma	Spfs	Plataforma
Plataforma Antipeaxe	Spfs	Plataforma Antipeaxe
Plataforma Cívica Segura Limpio	Spfs	Plataforma Cívica Segura Limpio
Plataforma contra a Peaxe	Spfs	Plataforma contra a Peaxe
Pleno	Spms	Pleno
Pleno do Congreso	Spms	Pleno do Congreso
Pleno do Congreso dos Deputados	Spms	Pleno do Congreso dos Deputados
Pleno do Consello Xeral do Poder Xudicial	Spms	Pleno do Consello Xeral do Poder Xudicial
Pleno do Parlamento	Spms	Pleno do Parlamento
Pleno do Senado	Spms	Pleno do Senado
Poboacións Estelares	Sp00	Poboacións Estelares
Podgorica	Sp00	Podgorica
Podujevo	Sp00	Podujevo
Policía	Spfs	Policía
Policía Autónoma	Spfs	Policía Autónoma
Policía Autónoma Basca	Spfs	Policía Autónoma Basca
Policía Local	Spfs	Policía Local
Policía Nacional	Sp00	Policía Nacional
Policía Nacional	Spfs	Policía Nacional
Política Agraria Comunitaria	Spfs	Política Agraria Comunitaria
Política Educativa	Sp00	Política Educativa
Política Municipal	Sp00	Política Municipal
Política Pesqueira Común	Spfs	Política Pesqueira Común
Política Territorial	Sp00	Política Territorial
Política Territorial , Obras Públicas e Vivenda	Sp00	Política Territorial , Obras Públicas e Vivenda
Políticas	Sp00	Políticas
Politur	Sp00	Politur
Polonia	Sp00	Polonia
Pombal	Sp00	Pombal
Pons	Sp00	Pons
Ponteareas	Sp00	Ponteareas
Pontedeume	Sp00	Pontedeume
Pontenova	Sp00	Pontenova
Pontevedra	Sp00	Pontevedra
Porrás	Sp00	Porrás
Porriño	Sp00	Porriño
Pórtico	Sp00	Pórtico
Porto-Rial	Sp00	Porto-Rial
Portomarín	Sp00	Portomarín
Portugal	Sp00	Portugal
Posada	Sp00	Posada
Poupard	Sp00	Poupard
Pradera	Sp00	Pradera
Prado	Spms	Prado
Praterías	Sp00	Praterías
Prats	Sp00	Prats
Premier	Sp00	Premier
Premio Eixo Atlántico de Narrativa Galega e Portuguesa	Spms	Premio Eixo Atlántico de Narrativa Galega e Portuguesa
Premio Enrique Mariñas	Spms	Premio Enrique Mariñas
Premio Goya	Spms	Premio Goya
Premio Miguel de Cervantes	Spms	Premio Miguel de Cervantes
Premio Nobel de Medicina e de Fisioloxía	Sp00	Premio Nobel de Medicina e de Fisioloxía
Premio Nobel de Medicina e de Fisioloxía	Spms	Premio Nobel de Medicina e de Fisioloxía
Premio Príncipe de Asturias de Ciencias Sociais	Spms	Premio Príncipe de Asturias de Ciencias Sociais
Premio de Composición Andrés Gaos	Spms	Premio de Composición Andrés Gaos
Presentación	Spf0	Presentación
Presidencia	Spfs	Presidencia
Presidencia Federal	Spfs	Presidencia Federal
Presidencia do Goberno	Spfs	Presidencia do Goberno
Presupostos Xerais do Estado	Spmp	Presupostos Xerais do Estado
Prieto	Sp00	Prieto
Primakov	Sp00	Primakov
Primaria	Sp00	Primaria
Primeira Cegoña de Ouro	Spfs	Primeira Cegoña de Ouro
Primeiro de Maio	Spms	Primeiro de Maio
Principado	Sp00	Principado
Principado de Asturias	Sp00	Principado de Asturias
Principado de Mónaco	Sp00	Principado de Mónaco
Príncipe	Sp00	Príncipe
Pristina	Sp00	Pristina
Prizren	Sp00	Prizren
Pro-Río	Sp00	Pro-Río
Producto Nacional Bruto	Spms	Producto Nacional Bruto
Programa Padre	Spms	Programa Padre
Programa de Actuación Conxunta	Sp00	Programa de Actuación Conxunta
Programas Industriais e Infraestructuras Tecnolóxicas	Sp00	Programas Industriais e Infraestructuras Tecnolóxicas
Protección do Patrimonio Cultural	Sp00	Protección do Patrimonio Cultural
Provence	Sp00	Provence
Proxecto Fiatex	Spms	Proxecto Fiatex
Proxecto de lei de ordenación de a edificación	Spms	Proxecto de lei de ordenación de a edificación
Prudencio	Spm0	Prudencio
Psicoloxía do traballo e de as Organizacións	Sp00	Psicoloxía do traballo e de as Organizacións
Psicopedagoxía	Sp00	Psicopedagoxía
Puente de el Mundo	Spfs	Puente de el Mundo
Puerta	Sp00	Puerta
Pujol	Sp00	Pujol
Puleva	Sp00	Puleva
Pulpo	Sp00	Pulpo
Punta Arnela	Sp00	Punta Arnela
Purificación	Spf0	Purificación
Putin	Sp00	Putin
Puxeiros	Sp00	Puxeiros
Puy	Sp00	Puy
Puy Lecumberri	Sp00	Puy Lecumberri
Queizán	Sp00	Queizán
Quico	Spm0	Quico
Quince	Spmp	Quince
Quindós	Sp00	Quindós
Quinta Brigada do Exército	Spfs	Quinta Brigada do Exército
Quintana	Sp00	Quintana
Quintana Martelo	Sp00	Quintana Martelo
Quintanilla	Sp00	Quintanilla
Quintanilla Ulla	Sp00	Quintanilla Ulla
Quintela de Leirado	Sp00	Quintela de Leirado
Quintiliana	Spf0	Quintiliana
Quique	Spm0	Quique
Quiroga	Sp00	Quiroga
R. Ceñal	Sp00	R. Ceñal
R. Guerrini	Sp00	R. Guerrini
Rábade	Sp00	Rábade
Radio Galega	Spfs	Radio Galega
Radio Obradoiro	Sp00	Radio Obradoiro
Radio Televisión de Galicia	Spfs	Radio Televisión de Galicia
Rafa	Spm0	Rafa
Rafa Cid	Spm0	Rafa Cid
Rafa Cuíña	Spm0	Rafa Cuíña
Rafa Díez	Spm0	Rafa Díez
Rafa Díez Usabiaga	Spm0	Rafa Díez Usabiaga
Rafa Luz	Spm0	Rafa Luz
Rafa Martín Vázquez	Spm0	Rafa Martín Vázquez
Rafa Muñoz	Spm0	Rafa Muñoz
Rafa Nadal	Spm0	Rafa Nadal
Rafa Paz	Spm0	Rafa Paz
Rafa Villar	Spm0	Rafa Villar
Rafael	Spm0	Rafael
Rafael Arias Salgado	Spm0	Rafael Arias Salgado
Rafael Arias-Salgado	Spm0	Rafael Arias-Salgado
Rafael Dieste	Spm0	Rafael Dieste
Rafael Estrella	Spm0	Rafael Estrella
Rafael Hernando	Spm0	Rafael Hernando
Rafael Landazábal	Spm0	Rafael Landazábal
Rafael Ribó	Spm0	Rafael Ribó
Rafaela	Spf0	Rafaela
Rafiña	Spm0	Rafiña
Raikkonen	Sp00	Raikkonen
Rainiero	Spm0	Rainiero
Rajiv Gandhi	Spm0	Rajiv Gandhi
Rajoy	Sp00	Rajoy
Ram	Sp00	Ram
Rambouillet	Sp00	Rambouillet
Ramiráns	Sp00	Ramiráns
Ramírez	Sp00	Ramírez
Ramiro	Spm0	Ramiro
Ramón	Spm0	Ramón
Ramón Alonso Fernández	Spm0	Ramón Alonso Fernández
Ramón Arias	Spm0	Ramón Arias
Ramón Castromil	Spm0	Ramón Castromil
Ramón Jáuregui	Spm0	Ramón Jáuregui
Ramón Piñeiro	Spm0	Ramón Piñeiro
Ramón Poch	Spm0	Ramón Poch
Ramón Rego	Spm0	Ramón Rego
Ramona	Spf0	Ramona
Ramona Fernández López	Spf0	Ramona Fernández López
Ramona Maneiro	Spf0	Ramona Maneiro
Ramsés Pérez	Spm0	Ramsés Pérez
Ramstein	Sp00	Ramstein
Rande	Sp00	Rande
Raquel	Spf0	Raquel
Rato	Sp00	Rato
Raúl	Spm0	Raúl
Raxoi	Sp00	Raxoi
Ray Bradbury	Spm0	Ray Bradbury
Ray Loriga	Spm0	Ray Loriga
Ray Stevenson	Spm0	Ray Stevenson
Rayment	Sp00	Rayment
Real Academia Galega	Spfs	Real Academia Galega
Real Academia de Medicina e Cirurxía de Galicia	Spfs	Real Academia de Medicina e Cirurxía de Galicia
Real Decreto	Spms	Real Decreto
Real Decreto 63/95	Spms	Real Decreto 63/95
Real Filharmonía de Galicia	Sp00	Real Filharmonía de Galicia
Real Filharmonía de Galicia	Spfs	Real Filharmonía de Galicia
Recinto Feiral de a Coruña	Spms	Recinto Feiral de a Coruña
Rectorado	Spms	Rectorado
Rede Española de Aerobioloxía	Spfs	Rede Española de Aerobioloxía
Rede Galega de Información e Documentación Xuvenil	Spfs	Rede Galega de Información e Documentación Xuvenil
Rede de Información Xuvenil	Spfs	Rede de Información Xuvenil
Redondela	Sp00	Redondela
Redondela-Guillarei	Sp00	Redondela-Guillarei
Redondo	Sp00	Redondo
Regino Giráldez Boo	Spm0	Regino Giráldez Boo
Reimundo	Spm0	Reimundo
Reinaldo	Spm0	Reinaldo
Reino Unido	Sp00	Reino Unido
Rekarte	Sp00	Rekarte
Relacións con os Medios	Sp00	Relacións con os Medios
Relacións de pais alcólicos con os fillos	Spfp	Relacións de pais alcólicos con os fillos
Rembrandt	Sp00	Rembrandt
Remedios	Spf0	Remedios
Renda de integración social de Galicia	Spfs	Renda de integración social de Galicia
Renfe	Sp00	Renfe
Renfe-Fomento	Sp00	Renfe-Fomento
Rentería	Sp00	Rentería
Reppas	Sp00	Reppas
República Federal de Iugoslavia	Sp00	República Federal de Iugoslavia
República Iugoslava	Spfs	República Iugoslava
República de Kósovo	Sp00	República de Kósovo
Residencia Escolar de Colmenar	Spfs	Residencia Escolar de Colmenar
Retevisión	Sp00	Retevisión
Retrato de Quevedo	Spms	Retrato de Quevedo
Reventós	Sp00	Reventós
Rexina	Spf0	Rexina
Rexistro Xeral de a Universidade	Spms	Rexistro Xeral de a Universidade
Rey	Sp00	Rey
Rey Nóvoa	Sp00	Rey Nóvoa
Rey Pichel	Sp00	Rey Pichel
Rey Rodríguez	Sp00	Rey Rodríguez
Reynolds	Sp00	Reynolds
Rianxo	Sp00	Rianxo
Riazor	Sp00	Riazor
Ribadavia	Sp00	Ribadavia
Ribeira	Sp00	Ribeira
Ribó	Sp00	Ribó
Ricardo	Spm0	Ricardo
Richard	Spm0	Richard
Richard Attias	Spm0	Richard Attias
Richard B. Hoover	Spm0	Richard B. Hoover
Richard Bandini	Spm0	Richard Bandini
Richard Boucher	Spm0	Richard Boucher
Richard Breveté	Spm0	Richard Breveté
Richard Burton	Spm0	Richard Burton
Richard Dawkins	Spm0	Richard Dawkins
Richard Fariña	Spm0	Richard Fariña
Richard Ford	Spm0	Richard Ford
Richard Goldstone	Spm0	Richard Goldstone
Richard Gombin	Spm0	Richard Gombin
Richard Holbrooke	Spm0	Richard Holbrooke
Richard J. Lewis	Spm0	Richard J. Lewis
Richard Krill	Spm0	Richard Krill
Richard Loncraine	Spm0	Richard Loncraine
Richard Long	Spm0	Richard Long
Richard Mason	Spm0	Richard Mason
Richard Neave	Spm0	Richard Neave
Richard Nixon	Spm0	Richard Nixon
Richard Owen	Spm0	Richard Owen
Richard Parker-Bowles	Spm0	Richard Parker-Bowles
Richard Perle	Spm0	Richard Perle
Richard Peto	Spm0	Richard Peto
Richard Villarroel	Spm0	Richard Villarroel
Richards	Sp00	Richards
Ricky	Spm0	Ricky
Ricky Martin	Spm0	Ricky Martin
Ricky Rubio	Spm0	Ricky Rubio
Ridruejo	Sp00	Ridruejo
Riego, Paco del	Spm0	Riego, Paco del
Riki	Spm0	Riki
Riley	Sp00	Riley
Río Segura	Sp00	Río Segura
Ríos	Sp00	Ríos
Risga	Sp00	Risga
Rita	Spf0	Rita
Rivas	Sp00	Rivas
Rivas Fontán	Sp00	Rivas Fontán
Rivas Fontenla	Sp00	Rivas Fontenla
Rivas Negreira	Sp00	Rivas Negreira
Rivas Villanueva	Sp00	Rivas Villanueva
Roberto	Spm0	Roberto
Roberto Blanco Torres	Spm0	Roberto Blanco Torres
Roberto García Calvo	Spm0	Roberto García Calvo
Roberto Iglesias Domínguez	Spm0	Roberto Iglesias Domínguez
Robustiano	Spm0	Robustiano
Rocío	Spf0	Rocío
Rock Hudson	Spm0	Rock Hudson
Rodolfo	Spm0	Rodolfo
Rodrigo	Spm0	Rodrigo
Rodrigo Rato	Spm0	Rodrigo Rato
Rodríguez	Sp00	Rodríguez
Rodríguez Cadarso	Sp00	Rodríguez Cadarso
Rodríguez Lamas	Sp00	Rodríguez Lamas
Rolda de Toledo	Sp00	Rolda de Toledo
Rolda de noite	Spfs	Rolda de noite
Roma	Sp00	Roma
Román	Spm0	Román
Roman Jakobson	Spm0	Roman Jakobson
Roman Lob	Spm0	Roman Lob
Roman Polanski	Spm0	Roman Polanski
Roman Signer	Spm0	Roman Signer
Romanía	Sp00	Romanía
Romario	Spm0	Romario
Romay	Sp00	Romay
Romay Beccaría	Sp00	Romay Beccaría
Roosevelt	Sp00	Roosevelt
Roque	Spm0	Roque
Rosa	Spf0	Rosa
Rosa Conde	Spf0	Rosa Conde
Rosa Díez	Spf0	Rosa Díez
Rosa García	Spf0	Rosa García
Rosa García Amoedo	Spf0	Rosa García Amoedo
Rosa Miguélez	Spf0	Rosa Miguélez
Rosai	Sp00	Rosai
Rosalía	Spf0	Rosalía
Rosalía de Castro	Spf0	Rosalía de Castro
Rosario	Spf0	Rosario
Rosendo	Spm0	Rosendo
Rosendo Salvado	Spm0	Rosendo Salvado
Rosón	Sp00	Rosón
Rostropovich	Sp00	Rostropovich
Rota	Sp00	Rota
Roxelio	Spm0	Roxelio
Roxos	Sp00	Roxos
Rubalcaba	Sp00	Rubalcaba
Rubén	Spm0	Rubén
Rubén Sanz	Spm0	Rubén Sanz
Rudesinda	Spf0	Rudesinda
Rugova	Sp00	Rugova
Ruiz Gallardón	Sp00	Ruiz Gallardón
Rumanía	Sp00	Rumanía
Rusia	Sp00	Rusia
Ruta Xacobea	Sp00	Ruta Xacobea
S. Vettel	Sp00	S. Vettel
SER	Sp00	SER
SOS Familia	Spfs	SOS Familia
Sabela	Spf0	Sabela
Saber ler , saber editar	Spms	Saber ler , saber editar
Sabina	Spf0	Sabina
Sabino	Spm0	Sabino
Sabino Arana	Spm0	Sabino Arana
Sabino Fernández Campo	Spm0	Sabino Fernández Campo
Sabino López	Spm0	Sabino López
Sabino Torres	Spm0	Sabino Torres
Sabrina	Spf0	Sabrina
Sada-Oleiros-Betanzos	Sp00	Sada-Oleiros-Betanzos
Sadako Ogata	Spf0	Sadako Ogata
Sáenz	Sp00	Sáenz
Sáenz Cosculluela	Sp00	Sáenz Cosculluela
Sáenz de Santamaría	Sp00	Sáenz de Santamaría
Sáez	Sp00	Sáez
Sáez Ponte	Sp00	Sáez Ponte
Sagrario	Spf0	Sagrario
Sainz	Sp00	Sainz
Sáinz	Sp00	Sáinz
Sáinz de la Maza	Sp00	Sáinz de la Maza
Salamanca	Sp00	Salamanca
Salas de Goberno	Spfp	Salas de Goberno
Salas deGoberno	Spfp	Salas de Goberno
Salazar	Sp00	Salazar
Salcedo	Sp00	Salcedo
Salduba	Spfs	Salduba
Saleta	Spf0	Saleta
Salimat	Sp00	Salimat
Salimat 99	Sp00	Salimat 99
Salinas	Sp00	Salinas
Salnés	Sp00	Salnés
Salomé	Spf0	Salomé
Salón	Spms	Salón
Salón Internacional do Turismo de Cataluña	Spms	Salón Internacional do Turismo de Cataluña
Salón Nobre de Fonseca	Spms	Salón Nobre de Fonseca
Salón Principal	Spms	Salón Principal
Salón de Alimentación do Atlántico	Spms	Salón de Alimentación do Atlántico
Salvador	Spm0	Salvador
Samos	Sp00	Samos
Sampaio	Sp00	Sampaio
Samsung	Sp00	Samsung
Samsung Electronics	Sp00	Samsung Electronics
Samsung Galaxy Fold	Sp00	Samsung Galaxy Fold
Samuel	Spm0	Samuel
San Caetano	Sp00	San Caetano
San Cibrao	Sp00	San Cibrao
San Ciprián	Sp00	San Ciprián
San Clemente	Spms	San Clemente
San Francisco	Sp00	San Francisco
San Martiño Pinario	Sp00	San Martiño Pinario
San Paio de Antealtares	Sp00	San Paio de Antealtares
San Panlo	Sp00	San Panlo
San Rafael	Sp00	San Rafael
San Román	Sp00	San Román
San Sebastián	Sp00	San Sebastián
San Tomé	Sp00	San Tomé
San Vicente	Sp00	San Vicente
San Vicente do Mar	Sp00	San Vicente do Mar
Sánchez	Sp00	Sánchez
Sánchez Arévalo	Sp00	Sánchez Arévalo
Sánchez de León	Sp00	Sánchez de León
Sancristóbal	Sp00	Sancristóbal
Sanctus	Spms	Sanctus
Sandra	Spf0	Sandra
Sandra Barral	Spf0	Sandra Barral
Sandra Blanco	Spf0	Sandra Blanco
Sandra Carrasco	Spf0	Sandra Carrasco
Sandra Cisneros	Spf0	Sandra Cisneros
Sandra Fernández	Spf0	Sandra Fernández
Sandra Fuentes	Spf0	Sandra Fuentes
Sandra González	Spf0	Sandra González
Sandra Krautwaschi	Spf0	Sandra Krautwaschi
Sandra Mosquera	Spf0	Sandra Mosquera
Sandra Myers	Spf0	Sandra Myers
Sandra Pérez Bello	Spf0	Sandra Pérez Bello
Sandra Rojas	Spf0	Sandra Rojas
Sanidade	Sp00	Sanidade
Sanidade e Asuntos Sociais	Sp00	Sanidade e Asuntos Sociais
Sanidade e Servicios Sociais	Sp00	Sanidade e Servicios Sociais
Sanjurjo	Sp00	Sanjurjo
Sanjurjo Badía	Sp00	Sanjurjo Badía
Sanmartín	Sp00	Sanmartín
Santa Bárbara	Sp00	Santa Bárbara
Santa Cristina de Cobres	Sp00	Santa Cristina de Cobres
Santalices	Sp00	Santalices
Santamaría	Sp00	Santamaría
Santander	Sp00	Santander
Santi	Spms	Santi
Santiago	Spm0	Santiago
Santiago Fernández	Spm0	Santiago Fernández
Santiago Lanzuela	Spm0	Santiago Lanzuela
Santiago Santamaría	Spm0	Santiago Santamaría
Santiago de Compostela	Sp00	Santiago de Compostela
Santiorxo	Sp00	Santiorxo
Santo Adrián de Cobres	Sp00	Santo Adrián de Cobres
Santo Sava	Sp00	Santo Sava
Sara	Spf0	Sara
Sarah	Spf0	Sarah
Sarah Burton	Spf0	Sarah Burton
Sarah Cook	Spf0	Sarah Cook
Sarah Ferguson	Spf0	Sarah Ferguson
Sarah Jaffe	Spf0	Sarah Jaffe
Sarah Martin	Spf0	Sarah Martin
Sarah Palin	Spf0	Sarah Palin
Saraxevo	Sp00	Saraxevo
Sarmiento	Sp00	Sarmiento
Sarria	Sp00	Sarria
Sartre	Sp00	Sartre
Saúde	Sp00	Saúde
Saúde Pública	Sp00	Saúde Pública
Saul	Spm0	Saul
Saúl	Spm0	Saúl
Saul Takahashi	Spm0	Saul Takahashi
Savater	Sp00	Savater
Savine Vode	Sp00	Savine Vode
Scarlett Johansson	Spf0	Scarlett Johansson
Schopenhauer	Sp00	Schopenhauer
Schroeder	Sp00	Schroeder
Schubert	Spm0	Schubert
Schumacher	Sp00	Schumacher
Schuman	Sp00	Schuman
Scorsese	Sp00	Scorsese
Scotland Yard	Sp00	Scotland Yard
Scott Black	Spm0	Scott Black
Scott Burrell	Spm0	Scott Burrell
Scott Carson	Spm0	Scott Carson
Scott Kelly	Spm0	Scott Kelly
Scott Matthew	Spm0	Scott Matthew
Scott McClellan	Spm0	Scott McClellan
Scott Thomas	Spm0	Scott Thomas
Seagal	Sp00	Seagal
Sean Connery	Spm0	Sean Connery
Sean O'Keefe	Spm0	Sean O'Keefe
Sean Penn	Spm0	Sean Penn
Sean Thornton	Spm0	Sean Thornton
Seat	Sp00	Seat
Sebastián	Spm0	Sebastián
Sebastiana	Spf0	Sebastiana
Secretaría Xeral do Sergas	Spfs	Secretaría Xeral do Sergas
Secretaría de Estado de Asuntos Penitenciarios	Spfs	Secretaría de Estado de Asuntos Penitenciarios
Secretaría de Estado de Comercio , Turismo e Pemes	Spfs	Secretaría de Estado de Comercio , Turismo e Pemes
Secundaria	Sp00	Secundaria
Secundina	Spf0	Secundina
Secundino	Spm0	Secundino
Segovia	Sp00	Segovia
Segunda Guerra Mundial	Spfs	Segunda Guerra Mundial
Segura	Spms	Segura
Segura Limpio	Sp00	Segura Limpio
Segura Vivo	Sp00	Segura Vivo
Seguridade	Sp00	Seguridade
Seguridade Social	Spfs	Seguridade Social
Sela	Sp00	Sela
Selenia	Spf0	Selenia
Semana Verde	Spfs	Semana Verde
Semana de Promoción Turística de Galicia	Spfs	Semana de Promoción Turística de Galicia
Semana de Promoción Turística de Galicia en Madrid	Spfs	Semana de Promoción Turística de Galicia en Madrid
Seminario Conciliar de Sigüenza	Spms	Seminario Conciliar de Sigüenza
Seminario Internacional de Control de a Infección Hospitalaria	Spms	Seminario Internacional de Control de a Infección Hospitalaria
Senado	Spms	Senado
Senén Barro	Spm0	Senén Barro
Senén Bernárdez	Spm0	Senén Bernárdez
Sensor Proximity-FZU-39/B	Sp00	Sensor Proximity-FZU-39/B
Sepla	Sp00	Sepla
Sepla	Spms	Sepla
Serafín	Spm0	Serafín
Serbia	Sp00	Serbia
Sergas	Spms	Sergas
Sergi	Spm0	Sergi
Sergio Marqués	Spm0	Sergio Marqués
Serguéi Ivanenko	Spm0	Serguéi Ivanenko
Serguéi Markov	Spms	Serguéi Markov
Serguei Stepashin	Spm0	Serguei Stepashin
Serguéi Stepashin	Spm0	Serguéi Stepashin
Serguéi Stepashin	Spms	Serguéi Stepashin
Serra	Sp00	Serra
Servicio Galego de Saúde	Spms	Servicio Galego de Saúde
Servicio Universitario de Residencias	Spms	Servicio Universitario de Residencias
Servicio de Busca e Salvamento	Spms	Servicio de Busca e Salvamento
Servicio de Enfermidades Infecciosas	Spms	Servicio de Enfermidades Infecciosas
Servicio de Residencias	Spms	Servicio de Residencias
Servicio de Salvamento	Spms	Servicio de Salvamento
Severiano	Spm0	Severiano
Severino	Spm0	Severino
Severino Somoza	Spm0	Severino Somoza
Sevilla	Sp00	Sevilla
Sevilla-Barcelona	Sp00	Sevilla-Barcelona
Shakespeare	Spm0	Shakespeare
Shanghai	Sp00	Shanghai
Shaúl Mofaz	Spm0	Shaúl Mofaz
Shea	Sp00	Shea
Shehu	Sp00	Shehu
Shinkai Zahine Karokhail	Spf0	Shinkai Zahine Karokhail
Sigüeiro	Sp00	Sigüeiro
Sigüenza	Sp00	Sigüenza
Sil	Sp00	Sil
Silencio , Santiago de Compostela existe ...	Sp00	Silencio , Santiago de Compostela existe ...
Silicom Graphics	Sp00	Silicom Graphics
Silleda	Sp00	Silleda
Silva	Sp00	Silva
Silvia	Spf0	Silvia
Silvio	Spm0	Silvio
Simeón	Spm0	Simeón
Simón	Spm0	Simón
Simon Fortuyn	Spm0	Simon Fortuyn
Simon Peres	Spm0	Simon Peres
Simone Cristicchi	Spf0	Simone Cristicchi
Simone de Beauvoir	Spf0	Simone de Beauvoir
Simulador de Navegación do Camiño de Santiago	Spms	Simulador de Navegación do Camiño de Santiago
Sinbad	Spm0	Sinbad
Sindicato Interino do Ensino Galego	Spms	Sindicato Interino do Ensino Galego
Sindicato UXT	Spms	Sindicato UXT
Sindo	Spm0	Sindo
Sineiro	Sp00	Sineiro
Sinn Fein	Spms	Sinn Fein
Siria	Sp00	Siria
Sistema MIR	Spms	Sistema MIR
Sistema Nacional de Saúde	Spms	Sistema Nacional de Saúde
Sitiña	Spf0	Sitiña
Sixtina	Spfs	Sixtina
Skip	Sp00	Skip
Skopje	Sp00	Skopje
Slobodan Milosevic	Spm0	Slobodan Milosevic
Sober	Sp00	Sober
Sobre a territorialidade	Sp00	Sobre a territorialidade
Sociedade Artística Valle Inclán	Spfs	Sociedade Artística Valle Inclán
Sociedade Española de Cirurxía Bucal	Spfs	Sociedade Española de Cirurxía Bucal
Sociedade Española de Medicina Preventiva e Saúde Pública	Spfs	Sociedade Española de Medicina Preventiva e Saúde Pública
Sociedade Galega de Medio Ambiente	Spfs	Sociedade Galega de Medio Ambiente
Sociedade Voluntaria de Eutanasia	Spfs	Sociedade Voluntaria de Eutanasia
Socorro	Spf0	Socorro
Sofía	Spf0	Sofía
Sogama	Sp00	Sogama
Solana	Sp00	Solana
Solbes	Sp00	Solbes
Soler	Sp00	Soler
Somoza	Sp00	Somoza
Somozas	Sp00	Somozas
Sonia	Spf0	Sonia
Sonia Barreiro	Spf0	Sonia Barreiro
Sonia Couso	Spf0	Sonia Couso
Sonia Couso Fernández	Spf0	Sonia Couso Fernández
Sonia Deaño	Spf0	Sonia Deaño
Sonia Fernández Casal	Spf0	Sonia Fernández Casal
Sonia Fernández Patiño	Spf0	Sonia Fernández Patiño
Sonia Ferreira	Spf0	Sonia Ferreira
Sonia Ferrer	Spf0	Sonia Ferrer
Sonia Freire	Spf0	Sonia Freire
Sonia Gómez Castro	Spf0	Sonia Gómez Castro
Sonia Iglesias	Spf0	Sonia Iglesias
Sonia Monroig	Spf0	Sonia Monroig
Sonia Montroig	Spf0	Sonia Montroig
Sonia Rábade	Spf0	Sonia Rábade
Sonia Valladares	Spf0	Sonia Valladares
Sonia Valladares Lago	Spf0	Sonia Valladares Lago
Soria	Sp00	Soria
Sotillos	Sp00	Sotillos
Soutomaior	Sp00	Soutomaior
Spanair	Sp00	Spanair
Spielber	Sp00	Spielber
Sri Lanka	Sp00	Sri Lanka
Sriperumbudur	Sp00	Sriperumbudur
Stalin	Sp00	Stalin
Stan	Spm0	Stan
Staro Gradsko	Sp00	Staro Gradsko
Stavropol	Sp00	Stavropol
Stefan Morling	Spm0	Stefan Morling
Stefan Schneider	Spm0	Stefan Schneider
Stefan Stefanov	Spm0	Stefan Stefanov
Stefan Zweig	Spm0	Stefan Zweig
Stefano Longo	Spm0	Stefano Longo
Stepashin	Sp00	Stepashin
Steven Aftergood	Spm0	Steven Aftergood
Steven Berkeley	Spm0	Steven Berkeley
Steven González	Spm0	Steven González
Steven Seagal	Spm0	Steven Seagal
Steven Spielberg	Spm0	Steven Spielberg
Steven Tyler	Spm0	Steven Tyler
Stewart Brand	Spm0	Stewart Brand
Stewart Home	Spm0	Stewart Home
Stormont	Sp00	Stormont
Stravinsky	Sp00	Stravinsky
Straw	Sp00	Straw
Strobe Talbott	Spm0	Strobe Talbott
Stuart Gordon	Spm0	Stuart Gordon
Stuart Mill	Spm0	Stuart Mill
Stuart Murdoch	Spm0	Stuart Murdoch
Studio B	Spfs	Studio B
Suárez Canal	Sp00	Suárez Canal
Suárez Quintanilla	Sp00	Suárez Quintanilla
Subcomisión de Asuntos Monetarios	Spfs	Subcomisión de Asuntos Monetarios
Sudáfrica	Sp00	Sudáfrica
Suecia	Sp00	Suecia
Suíza	Sp00	Suíza
Supremo	Spms	Supremo
Surcin	Sp00	Surcin
Susan George	Spf0	Susan George
Susan Philipsz	Spf0	Susan Philipsz
Susan Sarandon	Spf0	Susan Sarandon
Susana	Spf0	Susana
Susana Doval González	Spf0	Susana Doval González
Suso	Spm0	Suso
Sylvain	Sp00	Sylvain
Sylvia Plath	Spf0	Sylvia Plath
Tabacalera	Sp00	Tabacalera
Taboada	Sp00	Taboada
Taboadadela	Sp00	Taboadadela
Taft Armandroff	Spm0	Taft Armandroff
Talbott	Sp00	Talbott
Tallada	Sp00	Tallada
Tamara	Spf0	Tamara
Tamara Abalde	Spf0	Tamara Abalde
Tamara Arroyo	Spf0	Tamara Arroyo
Tamara Feijóo	Spf0	Tamara Feijóo
Tamara García Cid	Spf0	Tamara García Cid
Tambourine	Sp00	Tambourine
Tamil Nadu	Sp00	Tamil Nadu
Tania	Spf0	Tania
Tanjug	Sp00	Tanjug
Tanjug	Spfs	Tanjug
Tareixa	Spf0	Tareixa
Tarragona	Sp00	Tarragona
Tarzán	Spm0	Tarzán
Tatiana Aristárjova	Spfs	Tatiana Aristárjova
Taylor	Sp00	Taylor
Te Deum	Spms	Te Deum
Teatro Colón	Spms	Teatro Colón
Teis	Sp00	Teis
Teis-Puxeiros	Sp00	Teis-Puxeiros
Tejero	Sp00	Tejero
Telecinco	Sp00	Telecinco
Telemadrid	Sp00	Telemadrid
Telespectadores Asociados de Cataluña	Sp00	Telespectadores Asociados de Cataluña
Televisión de Galicia	Sp00	Televisión de Galicia
Televisión de Galicia	Spfs	Televisión de Galicia
Televisión sen Fronteiras	Sp00	Televisión sen Fronteiras
Telmo	Spm0	Telmo
Tenerife	Sp00	Tenerife
Teo	Sp00	Teo
Teodomiro	Spm0	Teodomiro
Teodora	Spf0	Teodora
Teodoro	Spm0	Teodoro
Teolinda	Spf0	Teolinda
Teoría de a Literatura	Sp00	Teoría de a Literatura
Terceiro Ciclo	Sp00	Terceiro Ciclo
Tere	Spf0	Tere
Tere López Ameijeiras	Spf0	Tere López Ameijeiras
Terelu	Spf0	Terelu
Terelu Campos	Spf0	Terelu Campos
Terencio	Spm0	Terencio
Teresa	Spf0	Teresa
Teresa Palacios	Spf0	Teresa Palacios
Terminator	Sp00	Terminator
Terras de Amoeiro	Sp00	Terras de Amoeiro
Teruel	Sp00	Teruel
Tesourería	Spfs	Tesourería
Textilive	Sp00	Textilive
The Scottish Ballet	Sp00	The Scottish Ballet
Thereza Zabell	Spf0	Thereza Zabell
Thomas Peinfield Jackson	Spm0	Thomas Peinfield Jackson
Thomas Rosemberg	Spm0	Thomas Rosemberg
Tiago	Spm0	Tiago
Tiago Pérez	Spm0	Tiago Pérez
Tierra de Fuego	Sp00	Tierra de fuego
Tierra de fuego	Sp00	Tierra de fuego
Tigres	Spmp	Tigres
Tigres de Liberación de a Patria Tamil	Sp00	Tigres de Liberación de a Patria Tamil
Tim Burton	Spm0	Tim Burton
Tin Tin	Spm0	Tin Tin
Tin Tin en el Tibet	Sp00	Tin Tin en el Tibet
Tirana	Sp00	Tirana
Tiresias	Spm0	Tiresias
Tiruleque	Spm0	Tiruleque
Tito	Spm0	Tito
Tiziana Domínguez	Spf0	Tiziana Domínguez
Tiziano Ferro	Spm0	Tiziano Ferro
Tocino	Sp00	Tocino
Todd McCarthy	Spm0	Todd McCarthy
Tojeiro	Sp00	Tojeiro
Toledo	Sp00	Toledo
Tom Avery	Spm0	Tom Avery
Tom Berninger	Spm0	Tom Berninger
Tom Bosley	Spm0	Tom Bosley
Tom Chilton	Spm0	Tom Chilton
Tom Cruise	Spm0	Tom Cruise
Tom Feeney	Spm0	Tom Feeney
Tom Hanks	Spm0	Tom Hanks
Tom Hooper	Spm0	Tom Hooper
Tom Jones	Spm0	Tom Jones
Tom Rogers	Spm0	Tom Rogers
Tom Sawyer	Spm0	Tom Sawyer
Tom Waits	Spm0	Tom Waits
Tomás	Spm0	Tomás
Toni	Spm0	Toni
Tony Blair	Spm0	Tony Blair
Tony Blayr	Spm0	Tony Blayr
Tony Curtis	Spm0	Tony Curtis
Tony Doyle	Spm0	Tony Doyle
Tony Dumas	Spm0	Tony Dumas
Tony Ezquivel	Spm0	Tony Ezquivel
Tony Forwood	Spm0	Tony Forwood
Tony Lomba	Spm0	Tony Lomba
Tony Moog	Spm0	Tony Moog
Tony Salhoub	Spm0	Tony Salhoub
Tony Soprano	Spm0	Tony Soprano
Tony Tcheca	Spm0	Tony Tcheca
Toques	Sp00	Toques
Toquio	Sp00	Toquio
Torras	Sp00	Torras
Torres dos Andrade	Spfp	Torres dos Andrade
Torricelli	Sp00	Torricelli
Tosar	Sp00	Tosar
Toural	Sp00	Toural
Touriño	Sp00	Touriño
Trabada	Sp00	Trabada
Traballo	Sp00	Traballo
Traballo e Asuntos Sociais	Sp00	Traballo
Traballo e Asuntos Sociais	Sp00	Traballo e Asuntos Sociais
Tragobe	Sp00	Tragobe
Transportes	Sp00	Transportes
Trasalba	Sp00	Trasalba
Tratado de Ámsterdan	Spms	Tratado de Ámsterdan
Tres Poetas	Sp00	Tres Poetas
Triacastela	Sp00	Triacastela
Tribunais Superiores de Xustiza	Spmp	Tribunais Superiores de Xustiza
Tribunal	Spms	Tribunal
Tribunal Constitucional	Spms	Tribunal Constitucional
Tribunal Electoral	Spms	Tribunal Electoral
Tribunal Penal Internacional	Spms	Tribunal Penal Internacional
Tribunal Superior de Xustiza	Spms	Tribunal Superior de Xustiza
Tribunal Superior de Xustiza de Galicia	Spms	Tribunal Superior de Xustiza de Galicia
Tribunal Supremo	Spms	Tribunal Supremo
Tribunal de Xustiza	Spms	Tribunal de Xustiza
Tribunal do Xurado	Spms	Tribunal do Xurado
Trimble	Sp00	Trimble
Trip	Spfs	Trip
Tristán	Spm0	Tristán
Troia	Sp00	Troia
Trois-Frères	Sp00	Trois-Frères
Troitiño	Sp00	Troitiño
Trufiño	Spm0	Trufiño
Tucho	Spm0	Tucho
Tui	Sp00	Tui
Turespaña	Sp00	Turespaña
Turgalicia	Sp00	Turgalicia
Turismo	Sp00	Turismo
Turpín	Spm0	Turpín
Turquía	Sp00	Turquía
Txurdinaga	Sp00	Txurdinaga
UGT Galicia	Sp00	UGT Galicia
Ulises	Spm0	Ulises
Ulla	Sp00	Ulla
Ulrich Cartellieri	Spm0	Ulrich Cartellieri
Ulrich Engel	Spm0	Ulrich Engel
Ulster	Sp00	Ulster
Úlster	Sp00	Úlster
Ultratur	Sp00	Ultratur
Ultratur Andalucía	Spfs	Ultratur Andalucía
Ultratur Portugal-Viajes y Turismo	Spfs	Ultratur Portugal-Viajes y Turismo
Ultratur Viajes	Sp00	Ultratur Viajes
Ultratur Viajes	Spms	Ultratur Viajes
Ultser	Sp00	Ultser
Umberto Eco	Spm0	Umberto Eco
Umberto Lima	Spm0	Umberto Lima
Unesco	Sp00	Unesco
Unesco	Spfs	Unesco
Unidade de Alcoloxía	Spfs	Unidade de Alcoloxía
Unidade de Trastornos Alimentarios	Spfs	Unidade de Trastornos Alimentarios
Unidade de Trastornos de a Alimentación	Spfs	Unidade de Trastornos de a Alimentación
Unidade de Trastornos en a Alimentación	Spfs	Unidade de Trastornos en a Alimentación
Unión	Spfs	Unión
Unión Europea	Sp00	Unión Europea
Unión Europea	Spfs	Unión Europea
Unión Fenosa	Sp00	Unión Fenosa
Unión de el Pueblo Navarro	Sp00	Unión de el Pueblo Navarro
Unión por Panamá	Sp00	Unión por Panamá
Unións Agrarias	Sp00	Unións Agrarias
Universidade	Spfs	Universidade
Universidade Nacional de Educación a Distancia	Sp00	Universidade Nacional de Educación a Distancia
Universidade de Bahía Blanca	Spfs	Universidade de Bahía Blanca
Universidade de Kiev	Spfs	Universidade de Kiev
Universidade de Oxford	Spfs	Universidade de Oxford
Universidade de Pisa	Spfs	Universidade de Pisa
Universidade de Santiago	Sp00	Universidade de Santiago
Universidade de Santiago	Spfs	Universidade de Santiago
Universidade de Santiago de Compostela	Spfs	Universidade de Santiago de Compostela
Universidade de Verán	Spfs	Universidade de Verán
Universidade de Vigo	Spfs	Universidade de Vigo
Universidade de Western Oritario	Spfs	Universidade de Western Oritario
Universidade de a Coruña	Spfs	Universidade de a Coruña
Universidade de verán	Spfs	Universidade de verán
University Medical Center	Spms	University Medical Center
Urkullu	Sp00	Urkullu
Urraca	Spf0	Urraca
Urrusolo	Sp00	Urrusolo
Uruguai	Sp00	Uruguai
Uxía	Spf0	Uxía
Uxía Blanco	Spf0	Uxía Blanco
Uxío	Spm0	Uxío
Uxío González	Spm0	Uxío González
V. Aleixandre	Sp00	V. Aleixandre
V. Hachinski	Sp00	V. Hachinski
VI Convenio Colectivo	Spms	VI Convenio Colectivo
VIII Edición do Salón do Automóbil	Spfs	VIII Edición do Salón do Automóbil
VIII Salón do Automóbil de Vigo	Spms	VIII Salón do Automóbil de Vigo
VIII Salón vigués do Automóbil	Spms	VIII Salón vigués do Automóbil
VIII Xornadas galegas sobre o alcolismo	Spfp	VIII Xornadas galegas sobre o alcolismo
Vaamonde	Sp00	Vaamonde
Valdoviño	Sp00	Valdoviño
Valencia	Sp00	Valencia
Valensa	Sp00	Valensa
Valentín	Spm0	Valentín
Valentina Karachentseva	Spfs	Valentina Karachentseva
Valeria Fuenteseca	Spf0	Valeria Fuenteseca
Valery	Sp00	Valery
Valga	Sp00	Valga
Valjevo	Sp00	Valjevo
Valladares González	Spm0	Valladares González
Valladolid	Sp00	Valladolid
Vallarino	Sp00	Vallarino
Valle	Spm0	Valle
Valle Inclán	Spm0	Valle Inclán
Valle Pérez	Spm0	Valle Pérez
Valle Riestra	Spm0	Valle Riestra
Varadeiro	Sp00	Varadeiro
Varela	Spm0	Varela
Varela Buxán	Spm0	Varela Buxán
Varela Cabo	Spm0	Varela Cabo
Varela Durán	Sp00	Varela Durán
Varela Fariña	Spm0	Varela Fariña
Varela Jácome	Spm0	Varela Jácome
Varela Pol	Spm0	Varela Pol
Varela Rey	Spm0	Varela Rey
Varela Vázquez	Spm0	Varela Vázquez
Varela Zapata	Spm0	Varela Zapata
Varela de Montes	Spm0	Varela de Montes
Varela de la Iglesia	Spm0	Varela de la Iglesia
Varèse	Sp00	Varèse
Variety	Sp00	Variety
Vázquez	Sp00	Vázquez
Vazquez	Spm0	Vazquez
Vázquez Chaves	Sp00	Vázquez Chaves
Vazquez Pintor	Spm0	Vazquez Pintor
Vega	Sp00	Vega
Vegalsa	Sp00	Vegalsa
Vego Supermercados	Sp00	Vego Supermercados
Vegonsa	Sp00	Vegonsa
Velasco	Sp00	Velasco
Velázquez	Sp00	Velázquez
Veloso	Spm0	Veloso
Venceslau	Spm0	Venceslau
Venecia	Sp00	Venecia
Veneranda	Spf0	Veneranda
Venezuela	Sp00	Venezuela
Venres Santo	Sp00	Venres Santo
Venres Santo	Spms	Venres Santo
Ventura	Spm0	Ventura
Vera	Sp00	Vera
Vera Drake	Spf0	Vera Drake
Verdes	Spmp	Verdes
Verea	Sp00	Verea
Verín	Sp00	Verín
Vettel	Spm0	Vettel
Vía Digital	Sp00	Vía Digital
Vía Láctea	Spfs	Vía Láctea
Viajes Amado	Spfs	Viajes Amado
Viajes Politur	Sp00	Viajes Politur
Viajes Politur	Spfs	Viajes Politur
Viajes Vincit	Spfs	Viajes Vincit
Viana	Sp00	Viana
Vicente	Spm0	Vicente
Vicente Quindós	Spm0	Vicente Quindós
Vicente Sánchez de León	Spm0	Vicente Sánchez de León
Vicerrectorado de Coordinación	Spms	Vicerrectorado de Coordinación
Vicerrectorado de Estudiantes	Spms	Vicerrectorado de Estudiantes
Victim	Sp00	Victim
Víctor	Spm0	Víctor
Victor Chernomirdin	Spm0	Víctor Chernomirdin
Víctor Chernomirdin	Spm0	Víctor Chernomirdin
Víctor Manuel P.P.	Spm0	Víctor Manuel P.P.
Víctor Ríos	Spm0	Víctor Ríos
Víctor Sahuquillo	Spm0	Víctor Sahuquillo
Victoria	Spf0	Victoria
Vidal	Spm0	Vidal
Vidal Beneyto	Spm0	Vidal Beneyto
Vidal Bolaño	Spm0	Vidal Bolaño
Vidal Cuadras	Spm0	Vidal Cuadras
Vidal Domínguez	Spm0	Vidal Domínguez
Vidal Quadras	Spm0	Vidal Quadras
Vidal Sassoon	Spm0	Vidal Sassoon
Vidal Suárez	Spm0	Vidal Suárez
Vieites	Sp00	Vieites
Viena	Sp00	Viena
Vietnam	Sp00	Vietnam
Vietnan	Sp00	Vietnan
Vigo	Sp00	Vigo
Vigo-Cangas	Sp00	Vigo-Cangas
Vigo-Ourense	Sp00	Vigo-Ourense
Vigo-Teis-Puxeiros	Sp00	Vigo-Teis-Puxeiros
Viktor Flores	Spm0	Viktor Flores
Viktor Frankenstein	Spm0	Viktor Frankenstein
Viktor Frankl	Spm0	Viktor Frankl
Vila Nova de Cerveira	Sp00	Vila Nova de Cerveira
Vilaboa	Sp00	Vilaboa
Vilafranca do Bierzo	Sp00	Vilafranca do Bierzo
Vilagarcía	Sp00	Vilagarcía
Vilalba	Sp00	Vilalba
Vilanova	Sp00	Vilanova
Vilaquinte	Sp00	Vilaquinte
Vilar Casal	Sp00	Vilar Casal
Vilar Checa	Sp00	Vilar Checa
Vilar Landeira	Sp00	Vilar Landeira
Vilar Ponte	Sp00	Vilar Ponte
Vilar de Santos	Sp00	Vilar de Santos
Vilar do Val	Sp00	Vilar do Val
Vilariño	Sp00	Vilariño
Villalaín	Sp00	Villalaín
Villalobos	Sp00	Villalobos
Villalonga	Sp00	Villalonga
Villanueva	Sp00	Villanueva
Villanueva Herrera	Sp00	Villanueva Herrera
Villar	Sp00	Villar
Villarejo	Sp00	Villarejo
Villarino	Sp00	Villarino
Vilnaí	Sp00	Vilnaí
Viloíde	Sp00	Viloíde
Vincent	Spm0	Vincent
Vincent Connare	Spm0	Vincent Connare
Vincent Sarich	Spm0	Vincent Sarich
Vincent Weafer	Spm0	Vincent Weafer
Vincent van Gogh	Spm0	Vincent van Gogh
Violante	Spf0	Violante
Virginia	Spf0	Virginia
Virginia Acebes	Spf0	Virginia Acebes
Virginia Johnson	Spf0	Virginia Johnson
Virginia M. Axline	Spf0	Virginia M. Axline
Virginia Madsen	Spf0	Virginia Madsen
Virginia Torralba	Spf0	Virginia Torralba
Virginia Woolf	Spf0	Virginia Woolf
Virxinia	Sp00	Virxinia
Visitación	Spf0	Visitación
Vitoria	Sp00	Vitoria
Viva Tours	Sp00	Viva Tours
Viveiro	Sp00	Viveiro
Vivian Ramírez	Spf0	Vivian Ramírez
Viviano	Spm0	Viviano
Vivir Viajes	Spfs	Vivir Viajes
Vizcaya	Sp00	Vizcaya
Vladan Bojic	Spm0	Vladan Bojic
Vladímir Putin	Spm0	Vladímir Putin
W. Allen	Sp00	W. Allen
W. C. Williams	Sp00	W. C. Williams
W. Christopher	Sp00	W. Christopher
WWF / Adena	Sp00	WWF / Adena
Wald	Sp00	Wald
Wall Street	Sp00	Wall Street
Walter	Spm0	Walter
Walter Jertz	Spm0	Walter Jertz
Washington	Sp00	Washington
Webber	Sp00	Webber
Weller	Sp00	Weller
Wenceslao	Spm0	Wenceslao
Wentworth Estate	Sp00	Wentworth Estate
Westendorp	Sp00	Westendorp
White Wolfs	Sp00	White Wolfs
Wilheim Conrad Röntgen	Spm0	Wilheim Conrad Röntgen
Wilhelm Reich	Spm0	Wilhelm Reich
Wilkens	Sp00	Wilkens
Wilkie Collins	Spm0	Wilkie Collins
Will	Spm0	Will
Will Oldham	Spm0	Will Oldham
Willard O. Quine	Spm0	Willard O. Quine
Willem Elbers	Spm0	Willem Elbers
Willi	Spm0	Willi
William Barr	Spm0	William Barr
William Blake	Spm0	William Blake
William Bonin	Spm0	William Bonin
William Butler Yeats	Spm0	William Butler Yeats
William Clinton	Spm0	William Clinton
William Cohen	Spm0	William Cohen
William Daley	Spm0	William Daley
William Faulkner	Spm0	William Faulkner
William Hogarth	Spm0	William Hogarth
William Katt	Spm0	William Katt
William Katt	Spm0	William Katt
William Lynch	Spm0	William Lynch
William Marston	Spm0	William Marston
William Pfaff	Spm0	William Pfaff
William Provine	Spm0	William Provine
William R. Cline	Spm0	William R. Cline
William Randolph Hearts	Spm0	William Randolph Hearts
William Seidman	Spm0	William Seidman
William Shakespeare	Spm0	William Shakespeare
William Zeitier	Spm0	William Zeitier
Williams	Sp00	Williams
Williamson	Sp00	Williamson
Willian A. Haseltine	Spm0	Willian A. Haseltine
Willibald I. Holzer	Spm0	Willibald I. Holzer
Willy	Spm0	Willy
Willy Claes	Spm0	Willy Claes
Willy Loman	Spm0	Willy Loman
Willy Meyer	Spm0	Willy Meyer
Wilson	Sp00	Wilson
Wim Duisenberg	Spm0	Wim Duisenberg
Wim Fleischmann	Spm0	Wim Fleischmann
Win Butler	Spm0	Win Butler
Win Wenders	Spm0	Win Wenders
Windows	Sp00	Windows
Windows	Spms	Windows
Windows 2000	Sp00	Windows 2000
Windows 2000	Spms	Windows 2000
Windows 2000 Ready	Sp00	Windows 2000 Ready
Windows 98	Sp00	Windows 98
Windows 98 Segunda Edición	Sp00	Windows 98 Segunda Edición
Windows NT	Sp00	Windows NT
Windows NT 4.0	Sp00	Windows NT 4.0
Winehouse	Sp00	Winehouse
Winner	Sp00	Winner
Winston Churchill	Spm0	Winston Churchill
Wipp	Sp00	Wipp
Wisawa Szymborska	Spf0	Wisawa Szymborska
Witold Gombrowicz	Spm0	Witold Gombrowicz
Wittgenstein	Sp00	Wittgenstein
Woody	Spm0	Woody
Wuhan	Sp00	Wuhan
X Certame de Música Folk de Galicia Xuventude 99	Spms	X Certame de Música Folk de Galicia Xuventude 99
X. M. Martinez Oca	Spm0	X. M. Martinez Oca
XI Congreso Nacional de Formación non Regrada	Spms	XI Congreso Nacional de Formación non Regrada
XI Congreso Nacional de a Sociedade Española de Neu	Spms	XI Congreso Nacional de a Sociedade Española de Neu
XIII Congreso nacional de titulados mercantís e empresariais	Spms	XIII Congreso nacional de titulados mercantís e empresariais
XIV Día de Galicia en Euscadi	Spms	XIV Día de Galicia en Euscadi
XVIII Congreso Nacional de a Sociedade Española do Xeonllo	Spms	XVIII Congreso Nacional de a Sociedade Española do Xeonllo
Xabarín	Spms	Xabarín
Xabarín Club	Spms	Xabarín Club
Xabier	Spm0	Xabier
Xabier Arzalluz	Spm0	Xabier Arzalluz
Xabier Toba	Spm0	Xabier Toba
Xabier de Irala	Spm0	Xabier de Irala
Xacinta	Spf0	Xacinta
Xacinto	Spm0	Xacinto
Xacobeo	Spms	Xacobeo
Xacobeo 99	Spms	Xacobeo 99
Xácome	Spm0	Xácome
Xadrez do Camiño de Santiago	Spms	Xadrez do Camiño de Santiago
Xaén	Sp00	Xaén
Xaime	Spm0	Xaime
Xaime Illa	Spm0	Xaime Illa
Xaime Illa Couto	Spm0	Xaime Illa Couto
Xaime Pita	Spm0	Xaime Pita
Xaime Quessada	Spm0	Xaime Quessada
Xaime Rodríguez Arana	Spm0	Xaime Rodríguez Arana
Xan	Spm0	Xan
Xapón	Sp00	Xapón
Xaquín	Spm0	Xaquín
Xavi	Spm0	Xavi
Xavier	Spm0	Xavier
Xavier de Paz	Spm0	Xavier de Paz
Xefatura Superior de Policía	Spfs	Xefatura Superior de Policía
Xefatura de Servicio de Desenvolvemento Rural de a Coruña	Spfs	Xefatura de Servicio de Desenvolvemento Rural de a Coruña
Xelmírez	Spm0	Xelmírez
Xenaro	Spm0	Xenaro
Xenebra	Spf0	Xenebra
Xerardo	Spm0	Xerardo
Xerardo Estévez	Spm0	Xerardo Estévez
Xerardo Fernández Albor	Spm0	Xerardo Fernández Albor
Xeremías	Spm0	Xeremías
Xerión	Spm0	Xerión
Xermade	Sp00	Xermade
Xermán	Spm0	Xermán
Xerome	Spm0	Xerome
Xertrude	Spf0	Xertrude
Xerusalén	Sp00	Xerusalén
Xerusalén desde o aire	Sp00	Xerusalén desde o aire
Xesé	Spm0	Xesé
Xesús	Spm0	Xesús
Xesús Díaz	Spm0	Xesús Díaz
Xesús Laíño Briones	Spm0	Xesús Laíño Briones
Xesus López	Spm0	Xesus López
Xesus Palmou	Spm0	Xesus Palmou
Xesús Palmou	Spm0	Xesús Palmou
Xesús Pérez Varela	Spm0	Xesús Pérez Varela
Xesús Vega	Spm0	Xesús Vega
Xesusa	Spf0	Xesusa
Xian	Sp00	Xian
Xil	Spm0	Xil
Ximonde	Sp00	Ximonde
Xinzo	Sp00	Xinzo
Xinzo de Limia	Sp00	Xinzo de Limia
Xiradela	Sp00	Xiradela
Xirona	Sp00	Xirona
Xisela Franco	Spf0	Xisela Franco
Xixón	Sp00	Xixón
Xoán	Spm0	Xoán
Xoan Chrisóstomo	Spm0	Xoan Chrisóstomo
Xoan Hermida	Spm0	Xoan Hermida
Xoán Hermida	Spm0	Xoán Hermida
Xoan M. Carreira	Spm0	Xoan M. Carreira
Xoan Manuel Casares	Spm0	Xoan Manuel Casares
Xoan Miguel Barros Dios	Spm0	Xoan Miguel Barros Dios
Xoan Paulo	Spm0	Xoan Paulo
Xoán Paulo II	Spm0	Xoán Paulo II
Xoan Pereira	Spm0	Xoan Pereira
Xoan Piñón	Spm0	Xoan Piñón
Xoan Ramón Allegue	Spm0	Xoan Ramón Allegue
Xoan Soto	Spm0	Xoan Soto
Xoana	Spf0	Xoana
Xoaquín	Spm0	Xoaquín
Xoaquina	Spf0	Xoaquina
Xoel	Spm0	Xoel
Xosafat	Spm0	Xosafat
Xose	Spm0	Xose
Xosé	Spm0	Xosé
Xosé Cuíña	Spm0	Xosé Cuíña
Xosé Cuíña Crespo	Spm0	Xosé Cuíña Crespo
Xosé Luís Barreiro Rivas	Spm0	Xosé Luís Barreiro Rivas
Xosé Luís Méndez Ferrín	Spm0	Xosé Luís Méndez Ferrín
Xosé Manuel Beiras	Spm0	Xosé Manuel Beiras
Xosé Manuel Budiño	Spm0	Xosé Manuel Budiño
Xosé Manuel Pazos	Spm0	Xosé Manuel Pazos
Xosé Manuel Romay Beccaría	Spm0	Xosé Manuel Romay Beccaría
Xosé María Hernández Cochón	Spm0	Xosé María Hernández Cochón
Xosé Sánchez Bugallo	Spm0	Xosé Sánchez Bugallo
Xosefa	Spf0	Xosefa
Xudas	Spm0	Xudas
Xulgado de Instrucción	Spms	Xulgado de Instrucción
Xulgado número 9 de Instrucción	Spms	Xulgado número 9 de Instrucción
Xulián	Spm0	Xulián
Xulio	Spm0	Xulio
Xunta	Spfs	Xunta
Xunta Xeral	Spfs	Xunta Xeral
Xunta Xeral do Principado	Spfs	Xunta Xeral do Principado
Xunta de Galicia	Spfs	Xunta de Galicia
Xunta de Goberno	Spfs	Xunta de Goberno
Xunta de Municipios	Spfs	Xunta de Municipios
Xunta de Xefes de Estado Maior	Spfs	Xunta de Xefes de Estado Maior
Xunta dos Pobos	Spfs	Xunta dos Pobos
Xuntas Provinciais de Directores	Spfp	Xuntas Provinciais de Directores
Xuntas de Directores	Spfp	Xuntas de Directores
Xurxo	Spm0	Xurxo
Xustiza	Sp00	Xustiza
Xustiza	Spfs	Xustiza
Xusto	Spm0	Xusto
Yábloko	Sp00	Yábloko
Yahoo España	Sp00	Yahoo España
Yakovica	Sp00	Yakovica
Yannos Papantoniu	Spm0	Yannos Papantoniu
Yebra	Sp00	Yebra
Yebra-Pimentel	Sp00	Yebra-Pimentel
Yevgueni Primakov	Spm0	Yevgueni Primakov
Ynestrillas	Sp00	Ynestrillas
Yogures Nestlé	Sp00	Yogures Nestlé
Yoko Ono	Spf0	Yoko Ono
Yolanda	Spf0	Yolanda
Yolanda Barcina	Spf0	Yolanda Barcina
Yolanda Besteiro	Spf0	Yolanda Besteiro
Yolanda Castaño	Spf0	Yolanda Castaño
Yolanda Díaz	Spf0	Yolanda Díaz
Yolanda Ferreiro	Spf0	Yolanda Ferreiro
Yolanda García	Spf0	Yolanda García
Yolanda Gutiérrez	Spf0	Yolanda Gutiérrez
Yolanda Jácome Rodríguez	Spf0	Yolanda Jácome Rodríguez
Yolanda López	Spf0	Yolanda López
Yolanda Morillo	Spf0	Yolanda Morillo
Yolanda Pérez	Spf0	Yolanda Pérez
Yolanda Romero	Spf0	Yolanda Romero
Yolanda Valcárcel	Spf0	Yolanda Valcárcel
YouTube	Sp00	YouTube
Yuri Luzhkov	Spm0	Yuri Luzhkov
Zabell	Sp00	Zabell
Zacarías	Spm0	Zacarías
Zamora	Sp00	Zamora
Zapatero	Sp00	Zapatero
Zaplana	Sp00	Zaplana
Zaragoza	Sp00	Zaragoza
Zhu Bangzao	Spm0	Zhu Bangzao
Zidane	Sp00	Zidane
Zies	Spmp	Zies
Zivkovic	Sp00	Zivkovic
Zlugánov	Sp00	Zlugánov
Zona Franca	Spfs	Zona Franca
Zona Vella	Spfs	Zona Vella
Zonas Industriais Espontáneas	Sp00	Zonas Industriais Espontáneas
Zoraida	Spf0	Zoraida
Zoran Matkovic	Spm0	Zoran Matkovic
Zoran Zivkovic	Spm0	Zoran Zivkovic
Zuberoa	Sp00	Zuberoa
Zutabe	Sp00	Zutabe
iPad	Sp00	iPad
iPhone	Sp00	iPhone
laSexta	Sp00	laSexta
valentina	Spf0	valentina
