ACB	NPFS	Asociación de Clubes de Baloncesto
ADN	NCMP	ácido desoxirribonucleico
ADN	NCMS	ácido desoxirribonucleico
Adobe Photoshop	NPEL	Adobe Photoshop
Alameda	NPFS	Alameda
América	NPEL	América
AM	NCFP	amplitude modulation
AM	NCFS	amplitude modulation
Ana	NPFS	Ana
Anatomía de Grey	NPEL	Anatomía de Grey
Andorra	NPEL	Andorra
Ángel	NPMS	Ángel
Antiguo Oeste	NPMS	Antiguo Oeste
Argentina	NPEL	Argentina
ARN	NCMP	ácido ribonucleico
ARN	NCMS	ácido ribonucleico
Arosa	NPEL	Arosa
Arzúa	NPEL	Arzúa
Asociación de Clubes de Baloncesto	NPFS	Asociación de Clubes de Baloncesto
Asturias	NPEL	Asturias
Atapuerca	NPEL	Atapuerca
Atlántico	NPMS	Atlántico
Australia	NPEL	Australia
Avelinos	NPMP	Avelino
Ávila	NPEL	Ávila
Ayuntamiento	NPMS	Ayuntamiento
Baia	NPFS	Baia
Baitúa	NPMP	Baitúa
Banco de Bilbao Vizcaya	NPMS	Banco de Bilbao Vizcaya
Barcelona	NPEL	Barcelona
BBVA	NPMS	Banco de Bilbao Vizcaya
Bembibre	NPEL	Bembibre
Benavente	NPMP	Benavente
BENEGÁ	NPMS	Bloque Nacionalista Galego
Bertamiráns	NPEL	Bertamiráns
Bilbao	NPEL	Bilbao
Bloque Nacionalista Galego	NPMS	Bloque Nacionalista Galego
Bloque	NPMS	Bloque
BNG	NPMS	Bloque Nacionalista Galego
Brandon	NPMS	Brandon
Brión	NPEL	Brión
Bruselas	NPEL	Bruselas
BUP	NPEL	Bachillerato Unificado Polivalente
Burgos	NPEL	Burgos
Cádiz	NPEL	Cádiz
Cambados	NPEL	Cambados
Cangas	NPEL	Cangas
Cantabria	NPEL	Cantabria
Carretas	NPEL	Carretas
Castilla León	NPEL	Castilla León
Castilla	NPEL	Castilla
Castiñeiriño	NPMS	Castiñeiriño
Catón	NPMS	Catón
CD	NCMP	compact disc
CD	NCMS	compact Disc
CD-ROM	NCMP	compact disc-read only memory
CD-ROM	NCMS	compact disc-read only memory
CDU	NPMS	Christlich-Demokratische Union Deutschlands
Centro de Investigaciones Energéticas, Medioambientales y Tecnológicas	NPMS	Centro de Investigaciones Energéticas, Medioambientales y Tecnológicas
Checoslovaquia	NPEL	Checoslovaquia
Christlich-Demokratische Union Deutschlands	NPMS	Christlich-Demokratische Union Deutschlands
Christlich-Soziale Union in Bayern	NPMS	Christlich-Soziale Union in Bayern
CIEMAT	NPMS	Centro de Investigaciones Energéticas, Medioambientales y Tecnológicas
CIF	NCMP	código de identificación fiscal
CIF	NCMS	código de identificación fiscal
CNMV	NPFS	Comisión Nacional del Mercado de Valores
Coliseo	NPMS	Coliseo
Comisión Nacional del Mercado de Valores	NPFS	Comisión Nacional del Mercado de Valores
CONCACAF	NPFS	Confederation of North, Central American and Caribbean Association Football
Confederation of North, Central American and Caribbean Association Football	NPFS	Confederation of North, Central American and Caribbean Association Football
Congregación de Jesús	NPEL	Congregación de Jesús
Conxo	NPEL	Conxo
Copa de Europa	NPFS	Copa de Europa
Coruña	NPEL	Coruña
COU	NPEL	Curso de Orientación Universitaria
Cruceiro do do Galo	NPEL	Cruceiro do do Galo
Crucero del Gallo	NPEL	Crucero del Gallo
CSU	NPMS	Christlich-Soziale Union in Bayern
Curros Enríquez	NPEL	Curros Enríquez
DEA	NPFS	Drug Enforcement Administration
DEA	NPMS	Diploma de Estudios Avanzados
Derecho	NPEL	Derecho
Detroit	NPEL	Detroit
Deutsches Institut für Normung	NPMS	Deutsches Institut für Normung
DIN	NPMS	Deutsches Institut für Normung
Dios	NPMS	Dios
Direction de la Surveillance du Territoire	NPMS	Direction de la Surveillance du Territoire
DNA	NCMP	deoxyribonucleic acid
DNA	NCMS	deoxyribonucleic acid
DNI	NCMP	documento nacional de identidad
DNI	NCMS	documento nacional de identidad
Douglas Hofstadter	NPMS	Douglas Hofstadter
Drug Enforcement Administration	NPFS	Drug Enforcement Administration
DST	NPMS	Direction de la Surveillance du Territoire
DVD	NCMP	digital versatil disc
DVD	NCMP	digital video disc
DVD	NCMS	digital versatil disc
DVD	NCMS	digital video disc
EA	NPMS	Eusko Alkartasuna
Económicas	NPEL	Económicas
EH	NPMS	Euskal Herritarrok
Ejército Republicano Irlandés	NPMS	Ejército Republicano Irlandés
El Algarve	NPEL	El Algarve
El Corte Inglés	NPEL	El Corte Inglés
El País	NPMS	El País
Emilio	NPMS	Emilio
Empresariales	NPEL	Empresariales
Empresas	NPEL	Empresas
Erasmus	NPEL	Erasmus
ESO	NPMS	European Southern Observatory
España	NPEL	España
Estado	NPMS	Estado
Estados Unidos	NPEL	Estados Unidos
ETA	NPMS	Euskadi Ta Askatasuna
Europa	NPEL	Europa
Europa	NPFS	Europa
European Southern Observatory	NPMS	European Southern Observatory
Euskadi Ta Askatasuna	NPMS	Euskadi Ta Askatasuna
Euskal Herritarrok	NPMS	Euskal Herritarrok
Eusko Alkartasuna	NPMS	Eusko Alkartasuna
Familia	NPMS	Familia
FBI	NPMS	Federal Bureau of Intelligence
Federal Bureau of Intelligence	NPMS	Federal Bureau of Intelligence
Fédération Internationale de Football Association	NPFS	Fédération Internationale de Football Association
FIFA	NPFS	Fédération Internationale de Football Association
Filología	NPEL	Filología
Físicas	NPEL	Físicas
FLN	NPMS	Frente Nacional de Liberación
Florencia	NPEL	Florencia
Florencia	NPMS	Florencia
FM	NCFP	frecuencia modulada
FM	NCFS	frecuencia modulada
Fontana de Trevi	NPFS	Fontana de Trevi
Franco	NPEL	Franco
Frente Nacional de Liberación	NPMS	Frente Nacional de Liberación
Galeras	NPEL	Galeras
Galicia	NPEL	Galicia
Galway	NPEL	Galway
GEO	NPMP	Grupo Especial de Operación
Giuseppe	NPMS	Giuseppe
Gödel, Escher, Bach	NPEL	Gödel, Escher, Bach
Gran Hotel de La Toja	NPMS	Gran Hotel de La Toja
Grupo Especial de Operación	NPMP	Grupo Especial de Operación
Hacienda	NPEL	Hacienda
Hacienda	NPES	Hacienda
HB	NPMS	Herri Batasuna
HDL	NCFP	high density lipoprotein
HDL	NCFS	high density lipoprotein
Héctor	NPMS	Héctor
Herri Batasuna	NPMS	Herri Batasuna
Highet	NPMS	Highet
Historia	NPEL	Historia
HIV	NCMP	human immunodeficiency virus
HIV	NCMS	human immunodeficiency virus
Huelva	NPEL	Huelva
Huérfanas	NPFP	Huérfanas
Huertas	NPEL	Huertas
Intendente Mercantil	NPEL	Intendente Mercantil
Intendente Mercantil	NPMS	Intendente Mercantil
International Standard Organization	NPFP	International Standard Organization
International Standard Organization	NPFS	International Standard Organization
Internet	NPES	Internet
IRA	NPMS	Ejército Republicano Irlandés
Irlanda	NPEL	Irlanda
IRPF	NCMP	informe sobre de la renta de las personas físicas
IRPF	NCMS	informe sobre de la renta de las personas físicas
ISBN	NCMP	international standard book number
ISBN	NCMS	international standard book number
ISO	NPFP	International Standard Organization
ISO	NPFS	International Standard Organization
ISSN	NCMP	international standard series number
ISSN	NCMS	international standard series number
IU	NPMS	Izquierda Unida
IVA	NCMP	impuesto sobre el valor añadido
IVA	NCMS	impuesto sobre el valor añadido
Izquierda Unida	NPMS	Izquierda Unida
Jorge	NPMS	Jorge
Juliana	NPFS	Juliana
La Argentina	NPEL	La Argentina
La Baña	NPEL	La Baña
La Bañeza	NPEL	La Bañeza
La cultura clásica	NPEL	La cultura clásica
La Milagrosa	NPEL	La Milagrosa
Laraño	NPEL	Laraño
La tradición clásica	NPEL	La tradición clásica
La Voz de Galicia	NPFS	La Voz de Galicia
LDL	NCMP	low density lipoprotein
LDL	NCMS	low density lipoprotein
Londres	NPEL	Londres
LP	NCMP	long play
LP	NCMS	long play
Lugo	NPEL	Lugo
Madrid	NPEL	Madrid
Maghreb Arab Press	NPFS	Maghreb Arab Press
Magisterio	NPEL	Magisterio
Malta	NPEL	Malta
Manu González	NPMS	Manu González
Manu	NPMS	Manu
MAP	NPFS	Maghreb Arab Press
María	NPFS	María
Marías	NPFP	María
Medicina	NPEL	Medicina
Mediterráneo	NPMS	Mediterráneo
Menchu	NPFS	Menchu
Mercado Común del Sur	NPMS	Mercado Común del Sur
Mercosur	NPMS	Mercado Común del Sur
Miami	NPEL	Miami
Miladies	NPEL	Miladies
Milladoiro	NPEL	Milladoiro
Milladoiro	NPMS	Milladoiro
Mio Cid	NPEL	Mio Cid
MIR	NCMP	médico interno residente
MIR	NCMS	médico interno residente
Movimiento por la Paz, el Desarme y la Libertad	NPMS	Movimiento por la Paz, el Desarme y la Libertad
MPDL	NPMS	Movimiento por la Paz, el Desarme y la Libertad
Muros	NPEL	Muros
Nación	NPFS	Nación
NASA	NPFS	National Aeronautics and Space Administration
National Aeronautics and Space Administration	NPFS	National Aeronautics and Space Administration
National Basketball Association	NPFS	National Basketball Association
Navarra	NPEL	Navarra
Navidades	NPFP	Navidad
Navidad	NPEL	Navidad
Navidad	NPFS	Navidad
NBA	NPFS	National Basketball Association
NIF	NCMP	número de identificación fiscal
NIF	NCMS	número de identificación fiscal
Noa	NPFS	Noa
Nochebuenas	NPFP	Nochebuena
Obradoiro	NPMS	Obradoiro
OCDE	NPFS	Organización para la Cooperación y el Desarrollo Económico
Odontología	NPEL	Odontología
OEA	NPFS	Organización de Estados Americanos
Oeste	NPMS	Oeste
Oficina Internacional del Trabajo	NPFS	Oficina Internacional del Trabajo
OFM	NPFS	Orden de frailes menores
OIT	NPFS	Oficina Internacional del Trabajo
OM	NCFP	onda media
OM	NCFS	onda media
OMS	NPFS	Organización Mundial de la Salud
ONCE	NPFS	Organización Nacional de Ciegos de España
ONG	NCFP	organización no gubernamental
ONG	NCFS	organización no gubernamental
ONGS	NCFP	organización no gubernamental
ONU	NPFS	Organización de las Naciones Unidas
OPA	NCFP	oferta pública de adquisición de acciones
OPA	NCFS	oferta pública de adquisición de acciones
OPEP	NPFS	Organización de Países Exportadores de Petróleo
OP	NPFS	Orden de predicadores
Orden de frailes menores	NPFS	Orden de frailes menores
Orden de predicadores	NPFS	Orden de predicadores
Orden de San Agustín	NPFS	Orden de San Agustín
Orense	NPEL	Orense
Organización de Estados Americanos	NPFS	Organización de Estados Americanos
Organización de las Naciones Unidas	NPFS	Organización de las Naciones Unidas
Organización del Tratado del Atlántico Norte	NPFS	Organización del Tratado del Atlántico Norte
Organización de Países Exportadores de Petróleo	NPFS	Organización de Países Exportadores de Petróleo
Organización de Televisiones Iberoamericanas	NPFS	Organización de Televisiones Iberoamericanas
Organización Mundial de la Salud	NPFS	Organización Mundial de la Salud
Organización Nacional de Ciegos de España	NPFS	Organización Nacional de Ciegos de España
Organización para la Cooperación y el Desarrollo Económico	NPFS	Organización para la Cooperación y el Desarrollo Económico
OSA	NPFS	Orden de San Agustín
OTAN	NPFS	Organización del Tratado del Atlántico Norte
OTI	NPFS	Organización de Televisiones Iberoamericanas
Oviedo	NPEL	Oviedo
Padrón	NPEL	Padrón
Palacio de Raxoi	NPMS	Palacio de Raxoi
Palencia	NPEL	Palencia
PAN	NPMS	Partido de Acción Nacional
París	NPEL	París
Partido de Acción Nacional	NPMS	Partido de Acción Nacional
Partido de la Revolución Democrática	NPMS	Partido de la Revolución Democrática
Partido Nacionalista Vasco	NPMS	Partido Nacionalista Vasco
Partido Popular	NPMS	Partido Popular
Partido Revolucionario Institucional	NPMS	Partido Revolucionario Institucional
Partido Socialista Obrero Español	NPMS	Partido Socialista Obrero Español
Patria	NPFS	Patria
PC	NCMP	personal computer
PC	NCMS	personal computer
Pedro	NPMS	Pedro
Peleteiro	NPEL	Peleteiro
Pepsa	NPMS	Programa Experimental de Prescripción de Estupefacientes de Andalucía
Periodismo	NPEL	Periodismo
Photoshop	NPEL	Photoshop
PIB	NCMP	producto interior bruto
PIB	NCMS	producto interior bruto
Pirineo	NPMS	Pirineo
PMA	NPMS	Programa Mundial de Alimentos
PNV	NPMS	Partido Nacionalista Vasco
POD	NPMS	Plan de Organización Docente
Poema	NPMS	Poema
Policía Local	NPFS	Policía Local
Pombal	NPEL	Pombal
Pontepedriña	NPEL	Pontepedriña
Pontevedra	NPEL	Pontevedra
Porriño	NPEL	Porriño
Portela	NPEL	Portela
Portomouro	NPEL	Portomouro
Powerpoint	NPMS	Powerpoint
PP	NPMS	Partido Popular
PRD	NPMS	Partido de la Revolución Democrática
PRI	NPMS	Partido Revolucionario Institucional
Prisciliano	NPMS	Prisciliano
Profesorado Mercantil Privado	NPEL	Profesorado Mercantil Privado
Programa Experimental de Prescripción de Estupefacientes de Andalucía	NPMS	Programa Experimental de Prescripción de Estupefacientes de Andalucía
Programa Mundial de Alimentos	NPMS	Programa Mundial de Alimentos
Proyecto Hombre	NPEL	Proyecto Hombre
Proyecto Hombre	NPMS	Proyecto Hombre
PSOE	NPMS	Partido Socialista Obrero Español
Puente de Rande	NPMS	Puente de Rande
PYME	NCFP	pequeña y mediana empresa
PYME	NCFS	pequeña y mediana empresa
Quintana	NPFS	Quintana
Rajoy	NPEL	Rajoy
RASD	NPFS	República Árabe Saharaui Democrática
Raxoi	NPEL	Raxoi
RDC	NPFS	República Democrática del Congo
República Árabe Saharaui Democrática	NPFS	República Árabe Saharaui Democrática
República Democrática del Congo	NPFS	República Democrática del Congo
Ribeira	NPEL	Ribeira
RNA	NCMP	ribonucleic acid
RNA	NCMS	ribonucleic acid
R	NPEL	R
Rolling Stones	NPMP	Rolling Stones
Roma	NPEL	Roma
SAE	NPFS	Sociedad Anónima Española
San Isidro	NPEL	San Isidro
Santa Gadea	NPFS	Santa Gadea
Santa Isabel	NPEL	Santa Isabel
Santander Central Hispano	NPMS	Santander Central Hispano
Santander	NPEL	Santander
Santiago de Chile	NPEL	Santiago de Chile
Santiago	NPEL	Santiago
SCH	NPMS	Santander Central Hispano
SD	NPFS	Sociedad Deportiva Compostela
Seco	NPEL	Seco
Semana Santa	NPFS	Semana Santa
SERGAS	NPMS	Servicio Gallego de Salud
SEU	NPMP	Sindicato Español Universitario
Sevilla	NPEL	Sevilla
Sexta	NPFS	Sexta
SI	NCMP	sistema internacional de unidades
SI	NCMS	sistema internacional de unidades
SI	NPFS	Societatis Iesu
Sistema Cantábrico	NPMS	Sistema Cantábrico
SJ	NPFS	Societatis Iesu
SME	NCMP	sistema monetario europeo
SME	NCMS	sistema monetario europeo
Sociedad Anónima Española	NPFS	Sociedad Anónima Española
Sociedad Deportiva Compostela	NPFS	Sociedad Deportiva Compostela
Societatis Iesu	NPFS	Societatis Iesu
Sozialdemokratische Partei Deutschlands	NPMS	Sozialdemokratische Partei Deutschlands
SPD	NPMS	Sozialdemokratische Partei Deutschlands
TAC	NCMP	tomografía axial computarizada
TAC	NCMS	tomografía axial computarizada
TAE	NCFP	tasa anual equivalente
TAE	NCFS	tasa anual equivalente
TIR	NPMP	Transport International Routier
TIR	NPMS	Transport International Routier
TNT	NPFS	Turner Network Television
Transport International Routier	NPMP	Transport International Routier
Transport International Routier	NPMS	Transport International Routier
Turner Network Television	NPFS	Turner Network Television
UCI	NCFP	unidad de cuidados intensivos
UCI	NCFS	unidad de cuidados intensivos
UE	NPFS	Unión Europea
UFO	NCMP	unidentified flying object
UFO	NCMS	unidentified flying object
UGT	NPMS	Unión General de Trabajadores
UHF	NCFP	ultra high frequency
UHF	NCFS	ultra high frequency
UNESCO	NPFS	United Nations Educational, Scientific and Cultural Organization
Un eterno y grácil bucle	NPEL	Un eterno y grácil bucle
UNICEF	NPFS	United Nations International Children's Emergency Fund
Unión Europea	NPFS	Unión Europea
Unión General de Trabajadores	NPMS	Unión General de Trabajadores
United Nations Educational, Scientific and Cultural Organization	NPFS	United Nations Educational, Scientific and Cultural Organization
United Nations International Children's Emergency Fund	NPFS	United Nations International Children's Emergency Fund
United States of America	NPMS	United States of America
Universidad de Santiago de Compostela	NPFS	Universidad de Santiago de Compostela
URSS	NPFS	Unión de Repúblicas Socialistas Soviéticas
USA	NPMS	United States of America
USC	NPFS	Universidad de Santiago de Compostela
UVI	NCFP	unidad de vigilancia intensiva
UVI	NCFS	unidad de vigilancia intensiva
Vaticano	NPMS	Vaticano
Venecia	NPEL	Venecia
Venezuela	NPEL	Venezuela
Very Large Telescope	NPMS	Very Large Telescope
VHF	NCFP	very high frequency
VHF	NCFS	very high frequency
VHS	NCMP	video home system
VHS	NCMS	video home system
Vigo	NPEL	Vigo
VIH	NCMP	virus de inmunodeficiencia humana
VIH	NCMS	virus de inmunodeficiencia humana
VIP	NCMP	very important person
VIP	NCMS	very important person
Vite	NPEL	Vite
VLT	NPMS	Very Large Telescope
Vuelvamañana	NPEL	Vuelvamañana
Xunta de Galicia	NPFS	Xunta de Galicia
Xunta	NPFS	Xunta
Zaragoza	NPEL	Zaragoza
Alejandra	NPFS	Alejandra
Alejandro	NPMS	Alejandro
Alexandra	NPFS	Alexandra
Alfonso	NPMS	Alfonso
Alfredo	NPMS	Alfredo
Amelia	NPFS	Amelia
Ana	NPFS	Ana
Anamari	NPFS	Anamari
Andrés	NPMS	Andrés
Angustias	NPFS	Angustias
Antonio	NPMS	Antonio
Antón	NPMS	Antón
Anxo	NPMS	Anxo
Aquilino	NPMS	Aquilino
Augusta	NPFS	Augusta
Aurelio	NPMS	Aurelio
Aurora	NPFS	Aurora
Beatriz	NPFS	Beatriz
Begoña	NPFS	Begoña
Belina	NPFS	Belinda
Benito	NPMS	Benito
Berto	NPMS	Alberto
Alberto	NPMS	Alberto
Bárbara	NPFS	Bárbara
Candela	NPFS	Candela
Carlita	NPFS	Carla
Carlos	NPMS	Carlos
Carlota	NPFS	Carlota
Carmela	NPFS	Carmela
Carmen	NPFS	Carmen
Carol	NPFS	Carol
Castelao	NPMS	Castelao
Cecilia	NPFS	Cecilia
Chari	NPFS	Charo
Charito	NPFS	Charo
Charo	NPFS	Charo
Clarita	NPFS	Clara
Claudia	NPFS	Claudia
Cris	NPFS	Cris
Cristina	NPFS	Cristina
César	NPMS	César
Daniel	NPMS	Daniel
David	NPMS	David
Diego	NPMS	Diego
Dorotea	NPFS	Dorotea
Edelmiro	NPMS	Edelmiro
Elena	NPFS	Elena
Elisa	NPFS	Elisa
Elsa	NPFS	Elsa
Emilia	NPFS	Emilia
Emilio	NPMS	Emilio
Encarnación	NPFS	Encarnación
Eusebio	NPMS	Eusebio
Eva	NPFS	Eva
Fernanda	NPFS	Fernanda
Fernando	NPMS	Fernando
FP	NPEL	FP
Fran	NPMS	Fran
Félix	NPMS	Félix
Gabriela	NPFS	Gabriela
Gerardo	NPMS	Gerardo
Gloria	NPFS	Gloria
Hugo	NPMS	Hugo
Héctor	NPMS	Héctor
Iago	NPMS	Iago
Inma	NPFS	Inma
Inmaculada	NPFS	Inmaculada
Inés	NPFS	Inés
Ire	NPFS	Irene
Irene	NPFS	Irene
Isa	NPFS	Isa
Isa	NPFS	Isabel
Isaura	NPFS	Isaura
Jaime	NPMS	Jaime
Javi	NPMS	Javi
Javier	NPMS	Javier
Jesús	NPMS	Jesús
Jorge	NPMS	Jorge
Josechu	NPMS	Josechu
Josefa	NPFS	Josefa
José	NPMS	José
José Manuel	NPMS	José Manuel
José Ramón	NPMS	José Ramón
Juan	NPMS	Juan
Juan Manuel	NPMS	Juan Manuel
Juanito	NPMS	Juan
Julieta	NPFS	Julieta
Julio	NPMS	Julio
Julián	NPMS	Julián
Lali	NPFS	Lali
Laura	NPFS	Laura
Laureano	NPMS	Laureano
Leonardo	NPMS	Leonardo
Leopoldo	NPMS	Leopoldo
Lidia	NPFS	Lidia
Lisardo	NPMS	Lisardo
Lolita	NPFS	Lola
Lorena	NPFS	Lorena
Lourdes	NPFS	Lourdes
Luci	NPFS	Luci
Luciana	NPFS	Luciana
Lucía	NPFS	Lucía
Maica	NPFS	Maica
Manolo	NPMS	Manolo
Manu	NPMS	Manuel
Manuel	NPMS	Manuel
Manuela	NPFS	Manuela
Marcos	NPMS	Marcos
Mari	NPFS	Mari
Mari Luz	NPFS	Mari Luz
Maribel	NPFS	Maribel
Mariño	NPMS	Mariño
Marquitos	NPMS	Marcos
Marta	NPFS	Marta
Martiña	NPFS	Martiña
Marucha	NPFS	Marucha
Maruja	NPFS	Maruja
María	NPFS	María
María Emilia	NPFS	María Emilia
María Luisa	NPFS	María Luisa
Mateo	NPMS	Mateo
Mauro	NPMS	Mauro
Merche	NPFS	Merche
Miguel	NPMS	Miguel
Mila	NPFS	Mila
Modesto	NPMS	Modesto
Mónica	NPFS	Mónica
Nancy	NPFS	Nancy
Narciso	NPMS	Narciso
Noa	NPFS	Noa
Norma	NPFS	Norma
Nuri	NPFS	Nuri
Nuria	NPFS	Nuria
Pablo	NPMS	Pablo
Paco	NPMS	Paco
Paloma	NPFS	Paloma
Paquita	NPFS	Paquita
Pauliña	NPFS	Paula
Pepe	NPMS	Pepe
Pepito	NPMS	Pepe
Pilar	NPFS	Pilar
Pili	NPFS	Pilar
Puri	NPFS	Puri
Rafael	NPMS	Rafael
Ramiro	NPMS	Ramiro
Raúl	NPMS	Raúl
Reme	NPMS	Reme
Ricardo	NPMS	Ricardo
Rita	NPFS	Rita
Robert	NPMS	Robert
Roberto	NPMS	Roberto
Rocío	NPFS	Rocío
Rosa	NPFS	Rosa
Rosario	NPFS	Rosario
Rosi	NPFS	Rosi
Rubén	NPMS	Rubén
Sabela	NPFS	Sabela
Santi	NPMS	Santi
Sara	NPFS	Sara
Sarita	NPFS	Sara
Sofía	NPFS	Sofía
Soledad	NPFS	Soledad
Sonia	NPFS	Sonia
Susana	NPFS	Susana
Susi	NPFS	Susi
Suso	NPMS	Suso
Tania	NPFS	Tania
Tere	NPFS	Tere
Teresa	NPFS	Teresa
Teresita	NPFS	Teresa
Tonucha	NPFS	Tonucha
Toño	NPMS	Toño
Valentina	NPFS	Valentina
Vanesa	NPFS	Vanesa
Victoria	NPFS	Victoria
Víctor	NPMS	Víctor
Xosé	NPMS	Xosé
Yanet	NPFS	Yanet
Ágata	NPFS	Ágata
Álvaro	NPMS	Álvaro
Ángel	NPMS	Ángel
Íñigo	NPMS	Íñigo
Óscar	NPMS	Óscar
